creative	ADJ
once	ADV
summary	ADJ
institute	NN
confortable	ADJ
young	ADJ
welcomewould	V
400	CD
rer	NN
did	V
dead	ADJ
many	ADJ
talk	NN
electrical	ADJ
real	ADJ
working	V
parking	V
biggest	ADJ
animation	NN
wery	NN
review	NN
which	WDT
hospitality	NN
chance	NN
kuku	V
enthusiastic	ADJ
hardly	ADV
hip	NN
sorted	V
cabinets	NNS
why	WRB
executive	NN
is	V
tables	ADJ
stylish	ADJ
6	CD
furniture	NN
sneaky	NN
reachable	ADJ
superfriendly	ADV
gave	V
heart	NN
crazy	NN
40	CD
shelf	NN
date	NN
wasn	NN
client	NN
upgrades	NNS
queue	V
done	V
cruise	NN
udaivilas	ADJ
tennisfriends	V
underconstruction	ADJ
4years	CD
improvement	NN
distances	NNS
of	IN
en	ADJ
conference	NN
ultra	ADJ
queries	NNS
smooth	V
pasta	NN
overworked	V
between	IN
miss	ADJ
spirits	NNS
speaking	V
mangers	NNS
left	V
several	ADJ
picky	ADJ
2010	CD
interior	ADJ
super	ADJ
transfer	NN
tide	IN
foreign	ADJ
visitors	NNS
paying	V
ã¢ââ	NNP
would	MD
85	CD
bland	NN
inn	NN
sky	NN
photos	V
more	ADJ
restaraunts	NNS
orders	NNS
downside	V
department	NN
leeds	NNS
nespresso	V
tulip	ADV
10	CD
lake	ADJ
nationality	NN
grandaughter	NN
server	NN
gare	NN
bugs	NNS
peaceful	ADJ
directions	NNS
2011	CD
impressive	ADJ
state	NN
yaer	NN
eat	NN
stayed	V
luxuryfood	NN
corner	NN
lack	NN
again	ADV
forced	ADJ
luggage	NN
boat	NN
s	NN
servings	NNS
meters	NNS
level	V
programme	ADV
milad	ADJ
byron	IN
march	NN
trained	V
elderly	ADJ
darling	NN
called	V
supermarket	NN
far	ADV
sufficient	ADJ
inner	NN
glasses	NNS
worth	ADJ
sure	ADJ
chears	NNS
newspaper	NN
april	NN
especialy	NN
aldo	ADJ
ship	ADJ
sports	NNS
strongly	ADV
disappointment	V
so	ADV
gobelins	ADJ
rent	NN
weeks	NNS
amination	NN
been	V
nights	NNS
pintxos	ADJ
open	ADJ
seemed	V
unexpected	ADJ
enterainment	ADJ
relaxatio	NN
bit	NN
base	ADJ
brought	V
ã¢ââ	ADJ
arrival	NN
forks	NNS
torn	ADJ
tourists	NNS
bur	V
facilities	NNS
options	NNS
l	V
cancelled	V
finding	ADJ
relations	NNS
liverpool	V
grounds	NNS
greatincredible	ADJ
unless	IN
because	IN
perfectly	ADV
disabled	V
nite	ADJ
ignorant	NN
suppose	V
swim	ADJ
drain	NN
4	CD
hungry	ADJ
six	CD
hair	NN
friend	NN
match	NN
consider	V
fortunately	ADV
smoke	NN
cover	NN
soon	ADV
nes	NNS
cuddle	NNS
germans	NNS
possible	ADJ
sun	NN
care	NN
traveling	V
place	NN
enough	ADJ
village	NN
d	NN
they	PRP
twin	V
niuewstraat	ADJ
thinks	NNS
vast	ADJ
reservation	NN
fitnes	NNS
stairs	V
laying	V
look	NN
ia	ADJ
sercices	NNS
swans	NNS
splendid	ADJ
grubby	NN
afraid	ADJ
honest	NN
cook	NN
amazing	V
excusive	ADJ
noisy	NN
immediately	ADV
ã¢â±	ADJ
transport	NN
holes	NNS
weren	V
vegetarian	ADJ
changes	NNS
boutiques	V
radio	NN
books	NNS
trimphe	V
else	ADJ
renovation	NN
massive	ADJ
friendy	NN
being	V
packing	V
delighed	V
ã¢ââll	ADJ
reviews	NNS
lot	NN
swimmingpools	NNS
dream	V
warmbarman	NN
without	IN
countryside	NN
amsterdam	NN
certainly	ADV
field	NN
smaller	ADJ
overal	ADJ
france	NN
finish	ADJ
ritz	NN
lift	NN
og	ADJ
recommend	NN
shape	NN
beds	V
statements	NNS
literally	ADV
studio	NN
residents	NNS
canine	V
san	ADJ
cool	NN
unacceptable	ADJ
make	V
impression	NN
house	NN
there	EX
one	CD
unmatched	ADJ
skype	NN
leisure	NN
incredibly	ADV
;	:
deteriorating	V
shoes	NNS
doesn	ADV
deskstop	V
board	NN
exceptionally	ADV
building	V
repeatative	ADJ
death	NN
celebrations	NNS
girls	V
door	NN
wg	NN
main	ADJ
apartment	NN
structure	NN
add	V
vending	V
rear	ADJ
confusing	V
under	IN
machine	NN
fantastically	ADV
happily	ADV
feels	NNS
earned	V
toiletries	NNS
chairs	NNS
issue	NN
mess	NN
gets	V
smelled	V
idea	NN
buildings	NNS
allocated	V
linen	ADJ
gladly	ADV
flights	NNS
educated	V
bars	NNS
read	V
prepare	NN
jammed	V
dirt	NN
stephanie	NN
frankfurt	V
build	ADJ
amount	NN
favourite	ADJ
pleasant	ADJ
likewise	NN
technology	NN
ideal	V
shous	ADJ
marriott	NN
reflected	V
general	ADJ
dec	NN
inedible	ADJ
receptionist	ADJ
example	NN
enjoy	NN
feyyoz	NN
probably	ADV
flughaven	ADV
thoroughly	ADV
famous	ADJ
package	NN
summer	NN
domicile	NN
means	V
aerobic	ADJ
reception	NN
columbus	NN
dated	V
dress	NN
oversee	NN
relax	V
15	CD
feature	NN
no	DT
18th	ADJ
eg	NN
costs	NNS
minimum	ADJ
childrens	NNS
square	V
decently	ADV
foot	ADJ
attention	NN
deserts	NNS
realy	V
desserts	NNS
touristy	ADJ
ã¢ââm	NNP
knowledgeable	ADJ
manicured	V
renewed	V
perhaps	ADV
every	DT
pitches	NNS
son	V
winter	NN
vips	NNS
walls	NNS
giant	ADJ
2nd	CD
mistakes	NNS
classic	ADJ
miro	NN
rebuilding	V
terms	NNS
blocks	NNS
oasis	V
seine	ADJ
flat	ADJ
7	CD
charme	ADJ
okay	NN
highly	ADV
seats	NNS
avoid	V
makes	V
them	PRP
set	V
lagune	NN
liked	V
outside	IN
expected	V
by	IN
chose	ADJ
sastisfied	V
solved	V
across	IN
think	NN
damaged	V
terrace	NN
steigenburger	NN
impressed	V
delightful	ADJ
montmartre	NN
weekday	NN
table	ADJ
â´	NN
throw	NN
hbo	NN
scale	NN
knew	V
stopped	ADJ
garage	NN
mcdonalds	NNS
etc	V
basin	NN
grill	NN
sunbeds	NNS
assured	V
worked	V
this	DT
appartement	NN
builders	V
honeymooners	NNS
alwys	ADV
finished	V
white	ADJ
inexpensive	ADJ
gift	NN
wifi	NN
quite	ADV
unfriendly	ADV
recommended	ADJ
poland	NN
repeated	V
soft	ADJ
climb	NN
beaches	NNS
thursday	V
gilde	ADJ
breathtaking	V
garden	NN
park	NN
mice	NN
came	V
milk	ADV
applied	V
climation	NN
stays	V
sharm	ADJ
missing	V
reccomend	NN
separated	V
prepared	ADJ
market	NN
hotel	NN
polish	ADJ
mamlouk	NNS
cake	V
kindness	V
spaciousthe	ADJ
english	ADJ
friendly	ADJ
narrow	ADJ
transition	NN
costlier	NN
chosen	V
strict	ADJ
menu	NN
flies	NNS
bonus	V
opinion	NN
fist	NN
concerning	V
dubai	ADJ
topaz	NN
absolutely	ADV
sasha	ADJ
see	V
wireless	ADJ
excellent	ADJ
brandy	NN
toilet	NN
disaster	NN
tornese	ADJ
surge	NN
available	ADJ
daily	ADJ
warmly	NNS
feel	V
tray	ADJ
degrees	NNS
wilderness	ADJ
jean	ADJ
necessary	ADJ
paris	NN
adult	NN
varieties	NNS
advance	V
how	WRB
animations	NNS
true	ADJ
â·	ADJ
con	NN
dansing	V
rank	NN
dana	NN
child	NN
whisky	WRB
generally	ADV
inclysive	ADJ
dislike	NN
refurnished	V
pizzeria	NNS
ground	NN
6am	CD
lost	V
petros	NNS
competent	ADJ
travelling	V
should	MD
space	NN
guess	NN
completed	V
design	NN
powerful	ADJ
surf	NN
limited	V
dat	ADJ
tip	NN
collapses	NNS
dayfor	V
empty	ADJ
colleagues	NNS
accommodating	V
husband	NN
change	NN
heavily	ADV
nowadays	V
partying	V
cross	ADJ
game	NN
cusines	NNS
what	WP
u	V
anyone	NN
persistent	NN
ð¢his	NNP
rum	V
hilton	NN
homeless	NN
preciseness	NN
mainly	ADV
refrigerator	NN
stable	ADJ
rules	NNS
hall	V
ansd	V
travel	ADJ
romantic	ADJ
perfekt	NN
joy	NN
purpose	ADJ
honor	NN
invited	V
everã½one	CD
features	NNS
buses	V
km	ADJ
philosophical	ADJ
royal	NN
treatment	NN
infrastructure	NN
as	IN
suit	NN
bussiness	NN
brilliant	ADJ
titanic	NN
heated	V
cooking	NN
in	IN
pitch	NN
constantly	ADV
using	V
waiters	NNS
conclusion	NN
experienced	V
to	TO
better	ADV
royalty	NN
ness	IN
peoplethe	NN
opportunitys	NN
below	IN
appearances	NNS
missed	V
5days	CD
80	CD
backpackers	NNS
possibilties	NNS
saw	V
corridors	NNS
avoiding	V
europeans	NNS
manner	ADJ
rude	V
matress	ADJ
2014	CD
forum	NN
di	NN
nicely	ADV
continue	V
matter	NN
welcomes	NNS
crowded	V
35	CD
french	ADJ
customer	NN
europe	NN
90	CD
restaurant	NN
abundant	ADJ
claustrophobic	ADJ
very	ADV
plenty	ADV
hoped	V
slippers	NNS
restrooms	NNS
stolen	V
carparking	V
hussein	NN
linens	NNS
prefect	V
dam	ADJ
budget	NN
helpfulathe	NN
goggle	NN
nor	CC
speed	ADJ
american	ADJ
noticeable	ADJ
diversity	NN
flamingo	NN
steep	ADJ
video	NN
maybe	ADV
whose	WP$
expect	ADJ
snorkelling	V
peopel	NN
humid	ADJ
oriental	ADJ
rundown	V
basically	ADV
shadows	V
handicapped	V
admire	V
crazily	ADV
district	NN
who	WP
egyptian	V
extensive	ADJ
facilties	NNS
italian	ADJ
elegant	ADJ
halles	NNS
166	CD
bubba	NN
help	NN
channel	V
control	NN
tiny	ADJ
event	NN
remark	NN
8th	CD
litle	ADJ
arena	ADJ
meetings	NNS
meet	NN
disappointing	ADJ
travelodges	NNS
stress	V
thick	ADJ
side	NN
slendid	V
already	ADV
siro	ADJ
stops	NNS
defiantly	ADV
neither	CC
credit	NN
welsh	NN
tasteful	ADJ
restaurants	NNS
diidn	V
ijust	ADJ
cakes	NNS
unbelievable	ADJ
mould	ADJ
barcelona	NN
dedicaced	V
jaccuzzi	NN
clubs	NNS
gemma	V
gaps	NNS
replinished	V
info	ADJ
tube	NN
eastern	ADJ
odd	ADJ
luxor	NN
underneath	IN
co	NN
comfort	NN
had	V
knowledge	V
ibis	NN
courses	NNS
comfy	V
destroyed	ADJ
staffs	NNS
music	NN
discounts	V
managers	NNS
makers	NNS
buffet	V
program	NN
location	NN
correspond	NN
have	V
builnding	V
smokers	NNS
making	V
next	ADJ
neatly	ADV
dutch	ADJ
recommendation	NN
perfume	NN
âd	NNP
recommending	V
unpleasant	ADJ
aren	NNS
but	CC
rambla	V
hen	NN
catered	V
sadly	ADV
moneyi	ADJ
maid	NN
grand	ADJ
home	NN
police	NN
addition	NN
various	ADJ
single	ADJ
services	NNS
exhibition	NN
avoided	V
little	ADJ
rocko	ADJ
smiles	NNS
fingerprints	NNS
laughed	V
snacks	NNS
definitively	ADV
assist	V
overcrowd	ADJ
properly	ADV
miserable	ADJ
holland	NN
provide	V
sleep	ADJ
tele	NN
ã°â¢his	NNP
satisfied	V
chef	NN
poor	ADJ
held	V
golf	NN
got	V
hysterical	ADJ
exceptional	ADJ
mountains	NNS
pathã£â©	V
tallinn	ADJ
ã	ADJ
insects	NNS
such	ADJ
hence	NN
lovely	ADV
shoping	V
tanning	V
nord	ADJ
asian	NN
invaded	V
the	DT
cozy	NN
vip	NN
firenze	NN
elevators	NNS
recomend	V
elevator	NN
took	V
sunbed	ADJ
informing	NN
opted	V
track	NN
bedroom	NN
fall	NN
personnel	NNS
wouln	V
conveniently	ADV
silent	ADJ
buy	V
ash	ADJ
refund	NN
informed	V
check	NN
superb	NN
steam	NN
beaituful	NN
certain	ADJ
complain	NN
underwhelmed	V
own	ADJ
surprising	NN
from	IN
guys	NNS
spakenburg	V
comfortable	ADJ
always	ADV
normal	ADJ
opera	NN
sell	NN
closer	ADV
holiday	NN
curtains	V
requires	V
code	NN
notre	ADJ
possibility	NN
sauna	NN
than	IN
nov	ADJ
carte	ADJ
noise	NN
120	CD
norwiegen	NN
insisted	V
recent	ADJ
breathtaken	ADV
generous	ADJ
sandwiches	NNS
went	V
central	ADJ
appreciate	NN
my	PRP$
hope	NN
remind	V
milano	NN
known	V
egg	NN
daytime	NN
together	ADV
indeed	ADV
fish	ADJ
try	NN
year	NN
bed	V
accompanied	ADJ
hotels	NNS
waits	NNS
spent	V
vacation	NN
trips	NNS
website	ADJ
access	NN
cloth	NN
completely	ADV
office	NN
that	WDT
stares	V
run	V
effort	NN
hole	NN
businesstrips	NNS
believe	V
priced	V
terrific	ADJ
premises	NNS
arrived	V
railway	NN
saff	NN
â¬	NNP
faulty	NN
incl	NN
views	NNS
procedure	NN
included	V
situated	ADJ
glad	ADJ
any	DT
provides	V
know	V
flamenco	ADJ
playground	NN
appeared	V
immaculately	ADV
he	PRP
despite	IN
luxurous	ADJ
hang	NN
pointed	V
mina	ADV
restourant	ADJ
schiphol	NN
come	V
foor	ADJ
warm	ADJ
distance	NN
t	NN
helping	V
built	V
highways	NNS
management	NN
300	CD
accomodation	NN
tho	NN
you	PRP
magical	ADJ
anybody	NN
station	NN
alone	ADV
won	V
christmas	ADJ
bloody	NN
via	IN
exceptions	NNS
happy	ADJ
long	ADJ
ingredients	NNS
everywhere	ADV
larger	ADJ
registration	NN
trying	V
layover	CC
awesome	ADJ
sodas	ADJ
floors	NNS
7th	CD
or	CC
outskirts	NNS
trousers	NNS
issues	NNS
cereal	V
rimini	ADJ
bright	NN
reserved	V
hurghada	ADJ
prado	NN
cigarrum	NN
sea	NN
cope	NN
candy	NN
frankfurtter	NN
cathode	NN
named	V
lock	NN
scam	NN
e	NN
scandic	NN
landscaped	V
yourself	PRP
swift	ADJ
kettle	NN
procedures	NNS
diabolical	ADJ
buiseness	NN
minuscule	NN
earth	NN
feast	NN
checkouts	NNS
fun	V
about	IN
smelly	ADV
elina	ADJ
selected	V
cinema	NN
accommodation	NN
bigger	ADJ
dull	ADJ
nn	NN
time	NN
right	ADJ
large	ADJ
tv	NN
rest	NN
exact	NN
sablon	NN
visitor	NN
maintained	V
fat	ADJ
normally	ADV
money	NN
attrackts	NN
frills	V
south	ADJ
calimera	NN
for	IN
practical	ADJ
similar	ADJ
specific	NN
received	V
words	NNS
kept	V
trees	NNS
checkout	V
future	ADJ
higly	ADV
failing	V
1300	CD
audience	NN
goodthe	NN
dark	NN
booked	V
downstairs	NNS
layout	IN
spacy	NN
lots	NNS
choices	NNS
grey	V
wait	ADJ
use	NN
flower	NN
bathing	NN
responsibility	NN
connection	NN
speak	NN
described	V
conditions	NNS
cereals	NNS
plaesantly	ADV
learn	V
collected	V
sewage	NN
equipment	NN
score	NN
accustomed	V
unconfortable	ADJ
favorite	ADJ
repetitive	NN
goes	V
five	CD
love	NN
stationthe	NN
loveliest	ADJ
dust	NN
houses	NNS
and	CC
different	ADJ
singles	NNS
otherwise	ADV
letter	NN
burger	NN
port	NN
luxury	NN
âs	NNP
night	NN
y	NN
information	NN
calm	NN
de	IN
decoration	NN
thing	NN
easily	ADV
sunrise	ADJ
ones	NNS
common	ADJ
satisfaction	NN
good	ADJ
russian	ADJ
canal	NN
tidy	NN
linked	V
spotlessly	ADV
boys	V
wonderfully	ADV
smile	ADJ
queens	NNS
slow	ADJ
iron	NN
need	NN
passport	NN
focused	V
spaces	NNS
convention	NN
du	NN
koln	NN
disadvantages	V
period	NN
thrown	IN
chair	NN
everã£â½one	NN
desert	NN
these	DT
camp	NNS
anything	NN
find	V
welcoming	V
mother	NN
unpleasantness	ADJ
internal	ADJ
save	NN
simply	ADV
restful	ADJ
duty	NN
serious	ADJ
centrally	ADV
parts	NNS
advise	V
euro	ADJ
swimmingpool	NN
both	DT
country	NN
â	V
possitive	ADJ
anymore	ADV
all	DT
lunch	NN
brocken	V
with	IN
result	NN
charge	NN
immidiately	ADV
river	V
minute	NN
created	V
doing	V
chill	NN
difficult	ADJ
unclear	ADJ
city	NN
type	NN
thus	ADV
charged	V
20	CD
butt	NN
channels	NNS
3	CD
inclusive	ADJ
taking	V
housekeeping	V
nadia	ADJ
old	ADJ
air	NN
maximizes	V
palazzo	ADJ
begrudge	NN
streetside	NN
groups	NNS
phone	NN
standard	ADJ
eurostars	V
delicacies	NNS
altstadt	V
nearby	ADJ
woerden	ADJ
extraordinary	ADJ
sting	NN
kind	NN
700	CD
shaped	V
â±	NNP
interested	ADJ
impressions	NNS
ã¢ââs	V
2012	CD
unforgettable	ADJ
language	NN
sheets	NNS
campsite	V
paradise	NN
turned	V
lcd	ADJ
boring	ADJ
alphons	NNS
guest	V
flavouring	V
wide	ADJ
bike	NN
oterwise	NN
moved	V
cannot	ADJ
westminster	NN
urine	ADJ
school	NN
beautiful	ADJ
wine	NN
hell	NN
bilbao	IN
bar	NN
attractions	NNS
seashore	V
orly	ADV
those	DT
advantage	ADJ
ã¡gent	ADJ
tuscany	NN
smoked	V
traffic	NN
damage	NN
sunday	ADJ
deter	NN
double	ADJ
near	IN
bob	NN
cooks	NNS
overall	ADJ
flight	NN
seems	V
italien	ADJ
if	IN
fab	V
usually	ADV
even	ADV
restoration	NN
will	MD
renovarted	V
fridge	NN
baku	NN
most	ADV
area	NN
evening	ADJ
century	NN
lanka	NN
tha	NN
road	NN
desired	V
some	DT
other	ADJ
uncomfortable	ADJ
flag	NN
outdoor	ADJ
receptionists	NNS
smart	V
climbs	ADJ
class	NN
apart	NN
workouts	V
cigarette	NN
th	NN
pub	V
him	PRP
checking	V
heavy	ADJ
pretty	NNS
travelodge	V
suite	ADJ
surprise	NN
relaxed	V
sqm	ADJ
pass	NN
miami	NN
served	V
cocktails	NNS
ls	CC
full	ADJ
situation	NN
computers	NNS
trailer	V
hotelthe	ADJ
dorint	NN
ago	IN
denmark	NN
hearts	NNS
negga	ADV
beach	V
person	NN
couples	NNS
locate	V
influence	NN
bad	ADJ
unlike	IN
fault	NN
outstanding	ADJ
ã¢â·	NN
higher	ADJ
messe	NN
resorts	NNS
wear	V
fee	ADJ
actually	ADV
noice	ADJ
cuase	NN
intrusive	ADJ
unfortunately	ADV
drugs	NNS
sundays	NNS
attentive	V
foods	NNS
wonderful	ADJ
directly	ADV
functional	ADJ
stuff	NN
rain	NN
chldren	NN
treated	V
word	NN
stop	NN
few	ADJ
thomsons	NNS
games	NNS
massage	ADV
much	ADJ
metro	ADV
efficiently	ADV
animaters	V
subway	NN
offer	NN
selection	NN
then	ADV
der	V
taxi	NN
sofa	NN
going	V
pillows	NNS
kindly	ADV
style	NN
keep	V
team	NN
guests	NNS
sit	V
our	PRP$
are	V
discovery	ADJ
entertaintments	NNS
wanted	V
years	NNS
miles	NNS
per	IN
carpet	NN
back	ADV
gone	V
running	V
genuine	ADJ
sã£â¶dermalm	ADJ
montjuic	NN
we	PRP
choice	NN
adjusted	V
whole	ADJ
laugh	NN
plan	NN
itself	PRP
i	ADJ
immediate	V
according	V
students	NNS
swedish	ADJ
pools	NNS
stained	V
euros	ADJ
enter	NN
detail	NN
organization	NN
kids	NNS
answer	V
loud	ADJ
login	NN
lived	V
mall	ADJ
leave	V
hospitable	ADJ
quickly	ADV
when	WRB
idem	ADJ
deventer	NN
standards	NNS
placement	NN
upgrade	ADJ
complaints	NNS
card	NN
windows	V
la	V
trafford	NN
saturday	NN
owners	NNS
polite	V
friends	NNS
don	ADV
surely	ADV
sri	ADJ
bands	NNS
cologne	V
returning	V
remember	V
negative	ADJ
regrettably	ADV
paied	ADJ
please	NN
mostly	ADV
where	WRB
self	NN
during	IN
found	ADJ
attending	V
palace	NN
spoken	V
fast	ADV
juices	NNS
hof	V
shops	NNS
spot	ADV
1	CD
it	PRP
size	NN
passed	V
rented	V
olso	IN
emily	ADV
kã£â¶ln	V
prefer	NN
prompt	ADJ
month	NN
cleaned	V
ceiling	NN
sat	V
siena	ADJ
work	NN
places	NNS
first	ADV
bathrooms	NNS
claiming	V
tasted	V
stuck	ADJ
duck	NN
scenic	ADJ
highlights	NNS
complaint	NN
spoiled	V
storage	NN
among	IN
including	V
charm	NN
inside	IN
supburb	NN
locally	ADV
wooden	ADJ
therethank	NN
ã¢â´	NNP
handled	V
towels	NNS
timely	ADV
ã£â¡gent	ADJ
refurb	NN
vouchers	NNS
extremly	ADV
surprised	V
food	NN
eyesi	NN
13	CD
explain	NN
foyer	NN
airport	NN
complained	V
stations	NNS
14	CD
dishes	NNS
helped	V
frienly	ADV
pension	NN
enjoyable	ADJ
things	NNS
thoroughfare	NN
minded	V
conected	V
breaker	NN
comforts	V
youngsters	NNS
decor	V
jelly	ADV
nevertheless	ADV
10m2	CD
needs	NNS
wc	ADJ
worn	ADJ
outlet	NN
european	ADJ
pleasure	NN
courteous	ADJ
bellmen	NNS
system	NN
tag	V
9years	CD
organised	ADJ
stains	NNS
chain	NN
february	ADJ
madrasses	NNS
stars	NNS
soap	V
beware	NN
faded	V
painting	V
rail	NN
absolute	NN
platinum	NN
coffee	NN
aerea	ADJ
frequent	ADJ
constriction	NN
presented	V
plage	NN
b	NN
order	NN
days	NNS
walking	V
deprived	ADJ
non	ADJ
appart	ADJ
position	NN
touring	V
supervicion	NN
teenagers	NNS
disco	V
quit	NN
confirmation	NN
bathtub	NN
still	ADV
while	IN
delivery	NN
reason	NN
might	MD
staff	NN
wich	V
decorated	V
offered	ADJ
offering	NN
rose	V
lanxess	ADJ
cycling	V
inspection	NN
extrasthe	NN
finishes	NNS
vas	V
following	V
also	ADV
entertainment	NN
nicest	ADJ
languages	V
construction	NN
compact	NN
cleanest	ADJ
party	NN
minority	NN
swimming	V
schhh	ADJ
price	NN
countries	NNS
quicker	V
jumeriah	NN
placed	V
moquette	NN
weather	NN
speaks	NNS
noticed	V
greeted	ADJ
spa	NN
driving	V
touchwith	NN
recently	ADV
pants	V
bikes	ADJ
expectation	NN
angry	ADJ
were	V
cottages	NNS
afew	V
into	IN
disgusting	V
older	ADJ
huge	ADJ
aside	IN
spending	V
something	NN
easy	ADJ
floor	NN
swiming	V
funiture	NN
responsible	ADJ
above	IN
safe	ADJ
just	ADV
les	V
signal	ADJ
willing	ADJ
assorted	V
cleaning	NN
awayas	NN
safety	NN
up	RP
lousy	ADJ
clean	ADJ
pc	NN
give	V
letdown	ADJ
cater	NN
shabby	NN
mountain	NN
go	V
periferique	ADJ
close	ADV
performance	NN
gentle	NN
be	V
strip	ADJ
ate	ADJ
way	NN
business	NN
purposed	V
concept	NN
portions	NNS
get	V
allow	ADJ
occasions	NNS
bookingcom	V
george	NN
washbasin	NN
complex	ADJ
restaurat	NN
octoberfest	ADJ
late	ADJ
vice	NN
unhappy	ADJ
utrecht	ADJ
busy	ADJ
egypts	NNS
weal	V
tired	ADJ
hours	NNS
setting	V
azerbaijan	NNS
realised	V
ours	ADV
dj	ADJ
break	NN
dreamy	ADJ
elegance	NN
riverside	NN
transportation	NN
destination	NN
friendliness	NN
rated	V
travellers	NNS
3am	CD
not	ADV
staying	V
roll	ADJ
attitude	NN
finally	ADV
bridge	V
diner	NN
men	NNS
eight	CD
modest	ADJ
croissants	NNS
beginning	V
alive	ADJ
chipped	ADJ
manager	NN
knifes	NN
pictures	NNS
online	V
fashioned	V
greets	NNS
centre	V
cokes	NNS
least	ADJ
piece	ADJ
decorative	ADJ
convenience	NN
ordination	NN
preferred	V
rotten	V
a	DT
lighting	NN
tried	V
everyday	ADJ
lounge	NN
july	NN
looking	V
customers	NNS
takes	V
british	ADJ
quality	NN
washing	V
encountered	V
may	MD
mr	V
establishments	NNS
high	ADJ
wall	NN
lyon	NN
awful	ADJ
stunning	V
seeing	V
intervene	ADJ
lobby	NN
attendance	NN
climbing	V
planning	V
end	NN
fountain	NN
mention	NN
pull	NN
floods	NNS
ample	ADJ
worths	NNS
sister	ADJ
partner	NN
pluss	V
3rds	CD
revisiting	V
support	NN
dirtyour	V
delicious	ADJ
managed	V
shame	NN
pickpocketing	V
bath	NN
unique	ADJ
edible	ADJ
looks	NNS
throughout	IN
totally	ADV
started	V
after	IN
hour	NN
organized	V
ms	NN
maker	NN
mgmt	NN
robbed	V
keeping	V
weekenders	NNS
liable	ADJ
family	NN
marseillan	NN
experience	NN
approx	ADJ
water	NN
tourist	NN
deal	NN
dancers	NNS
cars	NNS
minus	CC
twist	ADJ
cultures	NNS
pay	V
personally	ADV
atmosphere	ADV
surrounding	V
cooperation	NN
ther	NN
nightclubs	ADJ
tuscan	ADJ
your	PRP$
well	ADV
rat	V
vieuz	NN
middle	NN
rock	NN
times	NNS
taken	V
life	NN
croissant	ADJ
pathã©	NN
restricted	V
adjacent	ADJ
beverage	NN
shop	NN
member	NN
regard	NN
though	IN
checked	ADJ
jam	NN
careful	ADJ
relatively	ADV
alley	ADJ
boy	NNS
heard	V
residential	ADJ
grab	NN
request	NN
smoking	NN
discount	NN
pricey	NN
redeeming	V
an	DT
husaband	NN
n	NN
troubles	NNS
cleaness	V
ride	ADV
etiquette	ADV
sound	ADJ
fairly	ADV
ll	ADJ
75	CD
luxuries	NNS
since	IN
advantadge	ADJ
german	ADJ
products	NNS
useless	ADV
outdated	V
exelent	ADJ
behind	IN
let	NN
entertain	V
sous	ADJ
walked	V
downtown	ADJ
louvre	NN
telling	V
cancelation	NN
recommendable	ADJ
big	ADJ
connect	NN
average	ADJ
tram	ADJ
hte	NN
amasing	V
egypt	ADJ
bread	NN
calling	V
reasons	NNS
smsevery	ADV
thessaloniki	V
cleanliness	NN
based	V
beyond	IN
russians	NNS
hermitage	ADJ
age	NN
160	CD
trip	NN
morning	NN
sã¶dermalm	NN
5	CD
although	IN
instead	ADV
balcony	ADJ
gym	NN
extremely	ADV
smelt	V
blend	ADJ
hotelmanager	NN
freezing	V
expense	ADJ
welcome	NN
problem	NN
another	DT
later	ADV
never	ADV
option	NN
90th	CD
perfect	ADJ
vitosha	NN
ã¢ââ¬	NN
at	IN
coach	NN
tasty	NN
paid	V
street	NN
expectations	NNS
timing	V
nothing	NN
mohamed	V
visited	V
can	MD
singke	V
tea	ADJ
alanani	ADJ
elysee	NN
plus	CC
rate	NN
pm	NNS
aqua	V
olive	ADJ
acoustic	ADJ
mistake	NN
concierge	NN
tee	NN
stay	V
â	ADJ
vehicles	NNS
arranged	V
screen	ADJ
competences	NNS
pompidou	V
steakhouse	ADJ
november	ADJ
pool	NN
allowing	V
down	RP
verz	NNS
originally	ADV
advertised	V
healthy	ADJ
50	CD
top	ADJ
menus	NN
sheraton	NN
wellness	NN
front	ADJ
dance	NN
par	NN
requests	NNS
ever	ADV
ask	V
re	ADJ
zone	NN
ã¢âât	NNP
away	ADV
amenities	V
shuttle	ADJ
eur	ADJ
streets	NNS
cheap	ADJ
met	V
active	ADJ
welcomed	ADJ
reputation	NN
turkish	ADJ
items	NNS
taught	V
robe	NN
continental	ADJ
take	NN
spoilt	NN
playing	V
terrible	ADJ
sol	NN
aimee	NN
holidaymy	NN
rubber	NN
rough	ADJ
meals	NNS
c	V
connected	V
upstairs	ADJ
children	NNS
safisfied	V
each	DT
explanation	NN
provided	V
employees	NNS
abit	V
quiet	ADJ
early	ADJ
whenever	NN
departure	NN
visiting	V
allwe	ADJ
problems	NNS
pre	V
spend	V
play	NN
ã£â	NN
annoying	V
cocktail	NN
minibar	NN
reef	NN
reliable	ADJ
staffthe	NN
cost	NN
world	NN
cut	NN
diffrent	NN
champs	NNS
trier	V
their	PRP$
public	ADJ
fitness	NN
steak	NN
choose	ADJ
roomstaff	NN
unclog	NN
tastes	V
ancient	ADJ
anna	NN
underground	ADJ
hear	ADJ
simplistic	ADJ
around	IN
scrambled	ADJ
beer	NN
myself	PRP
part	NN
smallest	ADJ
wi	NN
watching	V
walkways	NNS
reasonable	ADJ
nevskii	ADJ
town	NN
comfortablelounge	NN
ham	NN
aquagym	V
oliver	ADV
25	CD
maxxiland	NN
bliss	ADJ
site	NN
return	NN
light	ADJ
twice	ADV
job	NN
finest	ADJ
mean	ADJ
bulgaria	NN
invite	NN
tended	V
recomended	V
felt	ADV
furnished	ADJ
neightborhood	NN
respective	ADJ
steps	NNS
fi	V
impossible	ADJ
drinks	NNS
somewhere	ADV
madrid	V
sunny	V
me	PRP
rather	ADV
pyramid	V
funny	ADJ
payed	ADJ
theres	NNS
profession	V
singer	ADJ
lose	ADJ
patient	NN
couple	NN
tend	V
load	NN
champ	NN
enjoyed	V
trash	NN
pirates	NNS
stag	V
expensive	ADJ
checkin	NN
offers	NNS
blonde	V
intersection	NN
therefore	ADV
balu	ADJ
convenient	NN
animators	NNS
mondays	V
bedding	V
visit	NN
toast	NN
center	NN
ã¢ââd	NNP
day	NN
vineyards	NNS
feb	V
chaos	NN
tiling	NN
range	NN
breakfast	NN
dinner	NN
refurbishment	ADJ
seven	CD
name	NN
dolphin	ADJ
putting	V
argue	ADJ
weekend	NN
leaking	V
weekly	ADJ
taste	NN
ridiculous	ADJ
min	NN
juice	NN
nightclub	ADJ
trams	NNS
comparing	V
mexican	ADJ
club	NN
course	NN
pond	NN
group	NN
actual	ADJ
gold	NN
show	NN
week	NN
stores	NNS
1st	CD
swipe	ADJ
triump	NN
connections	NNS
8	CD
kallithea	NNS
pantaneto	ADJ
needwe	ADJ
reach	NN
character	NN
arrivals	NNS
cause	V
affordable	ADJ
aerobicthey	NN
colorful	NN
mins	NNS
volvereta	V
variety	NN
located	V
24	CD
luxurious	ADJ
sensational	NNS
used	V
anyway	ADV
arc	ADJ
tub	NNS
practically	ADV
york	V
special	ADJ
worse	ADJ
roof	ADJ
international	ADJ
key	NN
numerous	ADJ
bus	NN
living	NN
suprised	V
hostel	ADV
largest	ADJ
new	ADJ
corridor	NN
great	ADJ
made	V
holidys	ADJ
additional	ADJ
eurostar	NN
renovated	V
cafe	ADJ
acommodation	NN
gardens	NNS
personal	ADJ
lights	NNS
amstel	NN
melia	V
pot	NN
ad	NN
repeat	NN
dirty	NN
starting	V
hr	NN
hardware	NN
internet	NN
acceptable	ADJ
excecutive	ADJ
excelent	NN
like	IN
commonly	ADV
importen	ADJ
sign	NN
lord	NN
now	ADV
highway	ADV
interest	NN
reseption	NN
updated	V
providing	V
book	NN
colors	NNS
live	V
moments	NNS
bathroom	V
failed	V
legs	ADJ
surroundings	NNS
over	IN
pastry	NN
someone	NN
was	V
restored	V
length	ADJ
members	NNS
midnight	V
definetely	ADV
classiest	ADJ
case	NN
secure	NN
began	V
except	IN
pluspoint	NN
namely	ADV
liquires	V
free	ADJ
creaky	NNS
copenhagen	NN
leaving	V
didn	NN
verry	FW
hard	ADJ
really	ADV
2	CD
allowed	V
before	IN
dine	NN
villa	NN
said	V
express	ADJ
9	CD
happened	V
cleaners	NNS
train	V
wash	ADJ
chic	ADJ
worst	ADJ
prostitutes	NNS
thats	NNS
oriented	V
ideally	ADV
tonic	ADJ
heating	NN
gran	V
three	CD
suprise	NN
pubs	NN
here	ADV
borring	V
beautifully	ADV
service	ADV
nearly	ADV
alternation	NN
hallmark	NN
lines	NNS
bring	V
repair	NN
till	NN
until	IN
hi	ADJ
fit	ADJ
lamps	NNS
ihad	V
1mile	CD
oberoi	NN
status	NN
proximity	NN
casa	V
deira	ADJ
mail	NN
neighborhoods	NNS
fully	ADV
hand	NN
plays	NNS
architecture	V
variuos	ADJ
london	NN
desk	NN
dusting	V
loved	V
call	ADJ
neighbourhood	NN
sray	NN
ala	NN
everytime	NN
roadside	V
us	PRP
disappointed	ADJ
lifestyle	ADJ
ã¢ââ	NN
everything	NN
spiderweb	NN
needed	V
espaccely	ADV
exchanging	V
varied	V
entrance	NN
seen	V
dining	V
professionell	NN
amel	ADV
ready	ADJ
adults	NNS
became	V
kã¶ln	ADJ
rooms	NNS
pleasantly	ADV
two	CD
couldn	ADJ
process	NN
amp;	NNS
say	V
requested	V
equipped	NNS
could	MD
clerk	V
upper	ADJ
especially	ADV
conditioning	V
18	CD
carlton	NN
broken	V
coming	ADJ
cottage	NN
walk	NN
vivaldi	NN
worries	NNS
salute	V
touristic	ADJ
anywhere	ADV
areas	NNS
2013	CD
faults	NNS
extended	V
attitudes	NNS
resort	NN
only	ADV
travelled	V
comments	NNS
kinds	NNS
number	NN
weekends	NNS
same	ADJ
professional	ADJ
antic	ADJ
handle	NN
espresso	ADJ
failure	NN
property	NN
choises	NNS
dorm	V
florence	NN
shower	NN
smell	NN
round	V
its	PRP$
belongings	NNS
isolation	NN
fresh	ADJ
whilst	ADJ
drunk	NN
view	NN
alright	V
comprehensive	ADJ
ve	NN
breakfasts	NNS
nl	ADV
does	V
meal	V
haven	ADJ
contemporary	ADJ
her	PRP$
ât	NN
replenished	V
cheese	ADJ
face	NN
having	V
on	IN
private	ADJ
akward	NN
thank	NN
pity	NN
itc	V
usual	ADJ
smiling	V
getting	V
meny	ADJ
nice	ADJ
feeling	NN
seaside	NN
mixed	ADJ
ervery	NN
everybody	NN
dissapointed	V
definitely	ADV
almost	ADV
fabulous	ADJ
possibly	ADV
small	ADJ
has	V
cant	V
facility	NN
availability	NN
am	V
present	ADJ
aforesaid	NN
serve	NN
room	NN
map	NN
jacuzzi	NN
dive	ADJ
start	NN
thought	V
booking	V
waiter	NN
fact	NN
dvd	V
mobile	ADJ
wife	NN
step	NN
observations	NNS
girl	V
indication	NN
star	NN
condition	NN
others	NNS
current	ADJ
minimal	ADJ
designed	V
compared	V
dirtyentertainment	NN
points	NNS
picturesque	V
tell	V
tasteswe	ADV
hundred	V
dish	ADJ
casino	NN
works	V
shopping	V
junior	ADJ
interesting	ADJ
touch	NN
too	ADV
ingeniously	ADV
afterwards	NNS
print	V
versa	ADJ
surprisingly	ADV
maximum	ADJ
attended	V
hot	ADJ
hamburger	ADV
marvellous	ADJ
line	NN
âll	NNP
trouble	NN
mega	ADJ
modern	ADJ
second	ADJ
wish	ADJ
workers	NNS
pleases	NNS
major	ADJ
passing	V
interestingin	NN
kassandria	NNS
heaven	ADV
snorkeling	V
behold	ADJ
apartments	NNS
enmenons	NNS
wheel	V
blue	ADJ
helpfull	NN
soup	NN
fulfilling	V
specially	ADV
wil	ADJ
yes	NNS
bacteria	V
holidays	NNS
bass	NN
activities	NNS
hamam	V
bistro	ADV
four	CD
quick	ADJ
proffesional	ADJ
reservations	NNS
marinachania	V
mini	ADJ
dogs	NNS
local	ADJ
paths	NNS
low	ADJ
keys	NNS
heater	NN
amp	V
evan	NN
looked	V
elysees	NNS
visible	ADJ
insulation	NN
allows	V
hosts	NNS
martha	V
helpful	ADJ
turkey	ADJ
typical	ADJ
coktailsstaff	NN
paper	NN
brings	V
spreads	NNS
ration	NN
off	IN
taxis	ADJ
cheaper	ADJ
dame	NN
tp	ADJ
getaway	ADV
marvelous	ADJ
television	NN
fatal	NN
regular	ADJ
association	NN
environment	NN
yet	ADV
hade	V
extra	ADJ
agia	NN
recognize	V
player	NN
territory	NN
window	NN
horrible	ADJ
recommendations	NNS
relaxing	V
due	ADJ
guy	NN
fantastic	ADJ
however	ADV
spacious	ADJ
supported	V
brits	NNS
duomo	NN
stupid	ADJ
ages	NNS
must	MD
ok	V
black	ADJ
pizza	NN
economically	ADV
70s	CD
doesen	ADJ
car	NN
point	NN
charming	V
didnt	ADJ
betting	V
somewhat	ADV
breaks	ADJ
entire	ADJ
goavoid	NN
disclose	V
incredible	ADJ
forward	ADV
efficient	ADJ
decent	NN
fitted	V
his	PRP$
given	V
haque	NN
note	NN
minutes	NNS
fine	V
276	CD
visits	NNS
assoiated	V
considering	V
overpriced	ADJ
axaha	IN
everyone	NN
less	CC
floaties	NNS
cared	V
m	ADJ
land	NN
staircase	NN
simple	ADJ
do	V
destinations	NNS
bathrobes	V
function	NN
varieous	ADJ
ensures	NNS
brussels	NNS
eran	V
improved	V
travelers	NNS
30th	CD
cuisine	NN
forthcoming	NN
considered	V
families	NNS
positive	ADJ
boulevar	NN
able	ADJ
pleaseure	NN
vacationpickalbatros	NN
thanks	NNS
likely	ADJ
extreme	ADJ
exercise	NN
yard	NN
reality	NN
seasight	V
tournaments	NNS
awfull	ADJ
best	ADJ
drink	NN
want	V
disadvantage	NN
disclosed	V
last	ADJ
marley	NN
wonderfull	NN
decided	V
respects	NNS
wasnt	NN
shows	V
hostess	NN
asked	V
suggest	ADJ
months	NNS
out	RP
12	CD
exposed	ADJ
rungis	NN
attractive	ADJ
covered	V
adequate	ADJ
cold	ADJ
straight	V
short	ADJ
mood	NN
persons	NNS
happiness	V
louise	ADJ
excursions	NNS
stone	V
reached	V
greek	ADJ
cracked	ADJ
backing	NN
within	IN
hopping	V
usd	ADJ
talking	V
steigenberger	NN
apply	V
kitchen	ADJ
â	NNP
redecorated	V
reply	NN
explore	IN
value	NN
tower	NN
people	NNS
respected	V
bother	ADV
basic	ADJ
exceeded	V
imposible	ADJ
she	PRP
mum	ADJ
meat	NN
monmarte	NN
yoghurt	NN
rates	NNS
closes	V
castelo	ADJ
escalator	NN
gorgeous	ADJ
vodka	NN
pipes	NNS
through	IN
30	CD
important	ADJ
