denmark	ddenmarc
closes	yn cau
checking	gwirio
rebuilding	ailadeiladu
extremely	hynod
major	mhrif
level	gwastataent
bit	dipyn
older	Henach
redeeming	adbrynu
eran	oedd
round	rownd
argue	dadleuent
kã¶ln	KÃ¶ln
decorative	addurnol
emily	emily
chance	siawns
students	fyfyrwyr
servings	noethiadau
ideal	ddelfrydol
stephanie	stephanie
shelf	silff
constantly	yn gyson
music	cerddoriaeth
centre	nghanolfan
mexican	Mecsicanaidd
beware	gwyliwch
cologne	cologne
ervery	phob
top	top
languages	Ieithoedd
sray	Thafarnau
floor	llawr
cancelled	canslo
smell	harogleuwch
ã¡gent	Àgent
activities	gweithgareddau
travellers	deithwyr
in	yn
deskstop	deskstop
liverpool	Lerpwl
worn	ngwan
nevskii	nevskii
event	nigwyddiad
prefect	prefion
seemed	ymddangoswyd
dorint	drinintau
laughed	chwerthin
words	ngeiriau
pirates	môr-ladron
hand	llaw
warmbarman	rhyfelfa
room	ystafell
considering	ystyried
to	i
cleaning	glanhau
garage	garej
tasteful	chwaethus
unfriendly	hanghyfeillgar
stuck	sownd
thinks	meddyliau
sensational	sensational
singer	canwr
variety	hamrywiaeth
chosen	ni
grand	chrand
saw	lifiet
looks	olwg
ansd	ansd
area	hardal
les	y
lack	diffyg
knowledgeable	yn wybodus
making	wneud
neightborhood	cymdogaeth
checked	gwirio
heavily	yn drwm
comfortablelounge	cyfforddus
n	n
flight	taith
husband	gŵr
distances	pellteroedd
ã	Ã-
der	y
lot	lot
frankfurt	Frankfurt
renovation	adnewyddiad
needwe	haneglur
breathtaking	syfrdanol
loved	chariadus
convenience	gyfleustra
travelled	teithiodd
minutes	nghofnodion
print	phrintiant
lanka	lanka
costs	costau
buiseness	busnes
always	bob amser
25	25
unmatched	hansawdd
ibis	ibis
range	amrediad
closer	agosach
abundant	doreithiog
each	phob un
noice	niodydd
deter	digalonnwch
completed	gwblhau
books	llyfrau
cleaned	glanhau
entertaintments	adloniant
an	a
surprised	synnu
thought	meddwl
slendid	sarnau
rather	yn hytrach
even	hyd yn oed
restrooms	ystafelloedd gorffwys
darling	darling
friendly	nghyfeillgar
field	faes
home	gartref
breaker	thorri
bus	fysiau
line	llinell
sunbed	gwely haul
smelt	smeltiais
go	aethant
nespresso	nespresso
fat	braster
palazzo	mhalazzo
sheraton	sheraton
magical	hudolus
2	2
big	mawr
someone	rhywun
courteous	gwrtais
staff	staff
thanks	diolch
matter	mater
wait	harhosi
construction	hadeiladiad
named	enwaf
was	oedd
defiantly	yn ddieithriad
quit	gadawed
sastisfied	fodlon
noticed	sylwi
bigger	mwy
trips	teithiau
organized	trefnus
paradise	baradwys
seen	gweld
balu	pêl
touristic	dwristiaeth
map	fapiau
missing	ar goll
probably	fwy na thebyg
charged	choded
taken	a gymerwyd
created	a grëwyd
info	gwybodaeth
excursions	gwibdeithiau
priced	phrisiau
handle	thrafodent
keys	allweddi
walk	cerdded
products	cynhyrchion
hussein	Hussein
public	nghyhoeddus
simple	syml
trafford	trafford
improvement	gwelliant
messe	messe
giant	cawr
although	er
calling	galwadau
attractions	atyniadau
standard	safonol
treatment	driniaeth
via	thrwy
numerous	niferus
extreme	eithafol
sofa	soffa
character	chymeriad
kassandria	Kassandria
rubber	rwber
dancers	dawnswyr
cars	ceir
water	ddyfrhau
port	porthladd
till	i
current	nghyfredol
site	gwefan
served	gwasanaethol
assist	gynorthwyo
worries	pryderon
brocken	frocen
mostly	yn bennaf
miserable	ddiflas
add	hatodir
3	3
ð¢his	ð ¢ ei
espaccely	espaccely
warmly	cynnes
chldren	plant
montmartre	Montmartre
stunning	trawiadol
definitively	yn bendant
correspond	chyfatebon
running	rhedeg
did	wnaeth
finding	dod o hyd
few	ychydig
extremly	eithafol
colors	lliwiau
show	harddangos
aside	o'r neilltu
ness	ness
changes	newidiadau
seashore	lanau
adequate	digonol
boring	ddiflas
mail	mhost
parking	parcio
personnel	mhersonél
accompanied	nghwmni
incredible	anhygoel
opinion	barn
slow	harefych
importen	fewnforio
sufficient	digon
handicapped	hanfantais
feature	nodwedd
pricey	drich
drinks	diodydd
welcoming	groesawgar
aerobic	aerobig
maker	gwneuthurwr
spot	hadnabûm
door	ddrws
functional	swyddogaethol
lifestyle	ffordd o fyw
canal	nghamlas
extra	chi
gorgeous	prydferth
deserts	anialwch
6	Est
stores	storfeydd
returning	ddychwelyd
â´	Â'
advantadge	Mantais
winter	gaeafan
down	i lawr
tables	tablau
shop	siopan
oriental	dwyreiniol
splendid	ysblennydd
belongings	eiddo
tallinn	nhallinn
son	mab
heated	gwresog
locate	lleolith
agia	agia
rear	fagwch
buildings	adeiladau
allowing	Caniatáu
bath	bath
stylish	steilus
ensures	yn sicrhau
own	haddefed
shows	dangos
varieous	hamrywiol
creative	greadigol
housekeeping	cadw tŷ
calm	lonyddwch
underneath	oddi tano
forced	gorfodaeth
disco	disgo
consider	hystyriwch
word	gair
persons	personau
into	i
general	nghyffredinol
save	hiached
â	â € œ
responsibility	chyfrifoldeb
complex	gymhleth
on	ymlaen
touring	deithiol
has	wedi
amenities	amwynderau
everyone	pawb
friends	ffrindiau
km	km
remind	hatgoffa
pictures	lluniau
flower	flodeuwch
prado	prado
purposed	ni
her	hi
13	13
paths	lwybrau
sunrise	heulwen
christmas	Nadolig
amp	amcaf
invaded	goresgyniad
mall	fall
point	bwyntiau
beds	gwelyau
cover	orchuddio
weekly	wythnosol
dvd	dvd
laying	osod
of	o
nov	Tachwedd
separated	gwahanu
purpose	diben
tasted	blaswyd
condition	cyflyrwch
negga	nega
book	lyfr
chears	Twrcyn
mixed	cymysg
meals	prydau
â·	Â ·
below	islaw
live	byw
aerobicthey	Aeroblichey
shower	cawod
afraid	hofni
beer	cwrw
âd	â € ™ d
peaceful	heddychlon
campsite	maes gwersylla
worth	werth
second	chefnogwyd
there	yno
reef	riffiau
almost	bron
way	ngweithred
yet	eto
district	hardal
same	yr un peth
upgrade	uwchraddiais
menu	newislen
royal	frenhinol
available	Ar gael
started	ddechreuwyd
fun	hwyl
letdown	nhinnau
safety	diogelwch
shuttle	gwennol
death	farwolaeth
concept	gysyniad
plenty	mab
bedding	dillad
practically	bron yn ymarferol
for	am
prepare	baratô
spaces	mannau
higher	uwch
adjusted	haddasu
taught	dysgu
vip	vipiwn
competent	gymwys
attended	mynychwyd
50	Cerbyd
german	Almaeneg
foods	bwydydd
provided	ddarperir
cinema	sinema
finish	gorffen
employees	gweithwyr
vice	is
suggest	awgrymant
repeat	ddyblent
40	Crynhowyd
degrees	graddfeydd
alive	fyw
welsh	Cymraeg
casa	tŷ
beautiful	hardd
cycling	feicio
something	rhywbeth
detail	manylwch
square	sgwâr
singles	senglau
30	30
arc	arc
problems	phroblemau
odd	rhyfedd
welcomes	yn croesawu
plan	cynlluniwch
end	clo
eight	wyth
horrible	erchyll
views	ngolygfeydd
residents	drigolion
advantage	Mantais
usually	fel arfer
charge	gwefr
melia	Melia
chairs	cadeiriau
t	t
presented	Cyflwynwyd
etc	etc
grounds	nhiroedd
found	sylfaenwyd
willing	barod
here	Yma
delicious	blasus
avoided	hosgo
patient	chlaf
tub	twb
perfectly	berffaith
driving	gyrru
brussels	brwsel
tele	teleych
corridor	choridor
personally	yn bersonol
do	gwnawn
travel	thrafaelent
ritz	ritz
relatively	gymharol
dislike	ddim yn hoffi
ate	hattiff
open	hagoron
recommendation	argymhelliad
kallithea	kallithea
eur	hota
requested	gais
reliable	dibynadwy
checkin	checkin
nn	nn
screen	sgriniwyd
less	Llawer
meters	metrau
remark	sylw
now	amod
saff	haenau
generous	hael
pitch	draw
troubles	drafferthion
gobelins	ngobelinau
makers	gwneuthurwyr
luxuryfood	luxuryfood
russian	Rwseg
euros	ewros
make	Creu
superfriendly	yn ofalus
picturesque	hardd
2013	2013
goes	mynd
july	mis Gorffennaf
electrical	drydanol
cared	medrus
fantastic	ffantastig
waits	aros
balcony	balconi
rat	llygoden
supburb	supburch
above	uchod
couple	cyplysed
forthcoming	i ddod
any	unrhyw un
overall	gyffredinol
are	yw
14	14
earth	daear
greets	cyfarchion
silent	ddistaw
disabled	hanabl
regular	reolaidd
carte	cribwch
looked	yn edrych
louise	louise
stayed	aros
delivery	dosbarthiad
realised	sylweddoli
pyramid	pyramid
relaxatio	ymlacio
thessaloniki	thessaloniki
rude	anghwrtais
finishes	gorffeniadau
tennisfriends	tendrisdiends
desk	ddesg
moquette	ngharped
smoking	ysmygu
station	gorsaf
triump	thaliwm
visitor	ymwelwyr
70s	70 x
burger	byrgyr
floors	lloriau
thus	felly
talk	pharablwch
placed	gosodir
speaking	siarad
as	fel
breakfasts	brecwast
husaband	Hafan.
fist	ddwrn
buffet	fwffe
feast	ngwledd
disappointment	siom
monmarte	Montmartre
morning	fore
part	gwahanwyd
sure	sicr
wife	Gwraig
oterwise	fel arall
tended	dued
various	amrywiol
stains	staeniau
intrusive	ymwthiol
which	sef
â±	Â ±
exercise	hymarferiad
comfy	comfy
reccomend	hadenillwyd
minuscule	minuscule
non	non
score	sgoriais
impressed	argraffus
fast	fuan
smaller	llai
dining	fwyta
reserved	neilltuedig
wouln	wouln
foot	nhroed
tiny	thiny
lost	golled
riverside	glan yr afon
bed	wely
chef	cogydd
grey	llwyd
floaties	fflôtiau
con	gyda
sewage	carthion
stars	sêr
weekday	Diwrnod yr Wythnos
crowded	gorlawn
lovely	hyfryd
toilet	thoiledau
areas	ardaloedd
allocated	nyrannu
suprised	synnu
paid	nhâl
mood	mood
nightclubs	clybiau nos
and	a
massage	tylino
cottages	bythynnod
city	dinasoedd
sun	haul
view	golygfeydd
aqua	aqua
everyday	pob dydd
homeless	digartref
strip	tynnwch
star	seriff
alanani	Botwm Chwarae
juices	sudd
ultra	ultra
roof	toi
flamingo	fflamingo
quick	nghryfed
facilties	cyfleusterau
international	rhyngwladol
exelent	mhwysol
linens	lieiniau
arena	arena
damaged	difrod
hotels	gwestai
pre	cyn
tee	tïwch
betting	betio
spiderweb	gwe pry cop
honor	hanrhydeddon
begrudge	harmuddiwn
providing	ddarperir
absolutely	hollol
ijust	ijust
collapses	cwympo
girls	merched
change	cyfnewidiasant
difficult	anodd
surge	ymchwyddent
expense	draul
shape	siâp
bathing	ymdrochiadau
shoping	siopa
thats	thats
y	Y
hot	poeth
fully	lawn
hostel	hostel
rank	reng
match	fatsian
20	Clai
also	hefyd
enthusiastic	frwdfrydig
a	a
glad	falch
fashioned	ffasiwn
steam	fygan
etiquette	moesau
much	llawer
dine	chi
transportation	chludiant
tho	tho
reseption	nerbynfa
clean	glanhwch
exposed	hamlagored
department	adran
theres	Mae
prefer	ffafriais
does	wneud
including	gan gynnwys
close	caead
arrived	gyrhaeddwyd
getting	goesau
managed	reoledig
rated	sgoriau
wonderfully	yn rhyfeddol
elevators	codwyr
adults	oedolion
three	dri
bland	duid
blue	glas
ingeniously	yn ddyfodol
transition	pontio
bilbao	bilbao
intersection	croestoriad
equipped	offer
architecture	pensaernïaeth
huge	enfawr
alright	alright
9	Mr
future	dyfodol
say	ddywedwch
this	hyn
wasn	nir
greek	Groeg
bulgaria	bwlgaria
enjoyable	bleserus
straight	syth
champ	champ
disappointing	siomedig
visiting	ymweliadau
rocko	rocko
though	ond
helped	help
maximizes	manteisio i'r eithaf
conclusion	nghasgliad
prepared	baratoadau
hundred	cant
with	gyda
moneyi	moneyi
enjoyed	mwynhau
booked	harchebu
solved	ddu
escalator	grisiau
aldo	aldo
smelled	drewllyd
torn	rhwygo
except	heblaw
establishments	sefydliadau
plaesantly	yn glir
pool	pŵl
desert	cefn
d	d
similar	debyg
cozy	glyd
year	flwyddyn
restourant	fwyty
washbasin	basn ymolchi
fault	fai
trams	cramiau
inclusive	gynhwysol
facility	cyfleusterau
typical	nodweddiadol
animators	animeiddwyr
steigenburger	Steigenberger
ground	daear
liable	atebol
may	Mai
orly	neu
meny	newislen
amstel	amstel
trip	daith
price	phrisiwyd
assoiated	nghysylltiedig
animaters	animeiddwyr
duty	dyletswydd
mistakes	camgymeriadau
everything	popeth
recent	diweddar
luxor	luxor
technology	dechnoleg
treated	driniaeth
encountered	dod ar eu traws
mamlouk	Mamluk
when	pryd
professional	phroffesiynol
poor	dlawd
tasteswe	Tasteswe
wi	A
smallest	lleiaf
proximity	agosrwydd
lock	cloi
smelly	drewllyd
5days	5days
been	wedi bod
help	chynorthwyaf
amel	weithrediad
liquires	hylifau
player	chwaraewr
club	glwb
main	mhrif
tend	dueddent
dutch	Iseldiroedd
travelers	deithwyr
come	dod
frienly	Nghyfeillgar
nightclub	Clwb nos
largest	mwyaf
jumeriah	jumeirah
bikes	feiciau
polish	sgleiniwn
super	super
keep	chadw
roll	troliwch
neighborhoods	cymdogaethau
ones	rhai
bathrobes	baddonau
connections	chysylltiadau
dam	argae
landscaped	wedi'i dirlunio
considered	hystyried
famous	enwog
visitors	ymwelwyr
tube	tiwb
12	12
beautifully	hyfryd
metro	metro
nor	nac
4	Gan
attentive	sylwgar
replenished	ailgyflenwi
confortable	gyfforddus
finest	nghynnyn
uncomfortable	anghyfforddus
spoiled	difetha
pm	pm
traveling	Teithio
wonderful	hyfryd
double	ddwbl
air	hawyrent
good	daer
immediately	ar unwaith
bands	bandiau
unforgettable	bythgofiadwy
hermitage	meudwy
expectations	disgwyliadau
park	parcied
floods	llifogydd
flies	pryfed
minimal	lleiaf
1300	1300
discovery	ddarganfyddiad
mess	llanast
destroyed	dinistriedig
short	byrion
la	y
cloth	brethyn
udaivilas	Udivilas
walked	Cerddodd
if	os
average	cyfartaledd
audience	gynulleidfa
following	dilynol
kept	cadw
nevertheless	serch hynny
wine	gwin
champs	Champs
cooking	coginio
entertainment	adloniant
economically	yn economaidd
pipes	pibellau
bathroom	ystafell ymolchi
diner	giniawa
sound	swn
perfume	persawrith
shops	siopiau
hard	galed
issues	faterion
small	bychan
bright	llachar
jean	jîns
ther	chi
places	lleoedd
castelo	Castell
makes	ddyfal
mr	mr
35	35
teenagers	pobl ifanc yn eu harddegau
mum	fam
where	lle
chose	dewisir
du	o
style	arddull
computers	Cyfrifiaduron
opportunitys	chyfleoedd
diidn	ngwrthod
moments	eiliadau
bar	bar
based	seiliedig
brandy	brandi
little	ychydig
10	10
wonderfull	rhyfeddod
next	Nesaf
tornese	thornness
comfortable	gyfforddus
setting	lleoliad
immediate	ar unwaith
mins	mins
held	dal
borring	yn ddiflas.
speaks	yn siarad
tourist	twristiaid
portions	dognau
staircase	grisiau
dead	farw
given	rhodd
day	Dydd
recomend	nweud
cabinets	cypyrddau
anymore	anymore
ve	a
came	ddaethon
restored	hadferiadau
hour	awr
designed	chynllun
stationthe	gorsaf
inspection	harolygiad
trouble	drafferthaf
departure	hymadawiad
excecutive	weithredwyr
redecorated	ailaddurno
throughout	drwyddi draw
hell	uffern
allwe	allwe
climbs	dringfeydd
lamps	lampau
smoked	mwg
basically	yn y bôn
length	hyd
amazing	anhygoel
earned	a enillwyd
hte	hte
varieties	mathau
advance	gynau
restaurants	bwytai
attention	sylw
offers	cynigion
cigarrum	cigarrwm
never	byth
definetely	yn bendant
tournaments	twrnameintiau
italian	Eidaleg
steigenberger	steigenberger
common	comin
very	ataf
distance	pellter
pitches	nghaeau
dedicaced	hymroddiad
furniture	dodrefn
neighbourhood	cymdogaeth
costlier	costus
nearly	bron
cant	gant
swipe	swipau
1	1
only	yn unig
but	ond
right	hawl
or	neu
bathtub	bathtub
efficiently	yn effeithlon
clubs	clybiau
maintained	a gynhelir
be	fydd
true	gwir
creaky	creaky
compared	wrthasid
observations	arsylwadau
wifi	wifi
nl	nl
18th	18fed
flavouring	flasus
bother	trafferthent
mention	crybwyll
indeed	yn wir
town	trefi
wery	ni
trained	hyfforddedig
pillows	nghlustogau
missed	golled
taste	phrofent
leeds	leeds
friend	ffrind
nice	neis
elegance	geinder
transport	drafnidyn
clerk	glercion
pity	dosturiwn
dreamy	freuddwydion
met	met
within	o fewn
antic	gorffennol
gran	wych
atmosphere	awyrgylch
before	cyn
recommendable	hargymell
romantic	rhamantaidd
elevator	elevator
s	s
touristy	dwrisiaid
would	fyddai
dana	dana
m	m
organised	trefnus
plays	dramâu
24	Mr
nicely	nicel
travelling	Teithio
versa	hallba
wish	hoffent
2011	2011
renovarted	Yn cael ei adnewyddu.
late	hwyr
somewhere	rhywle
vips	bygiau
russians	Rwsiaid
fantastically	wych
advise	cynghorwyd
necessary	angenrheidiol
hr	hr
copenhagen	nghopenhagen
daytime	yn ystod y dydd
will	ewyllysiodd
after	ar ôl
businesstrips	Businesstrips
transfer	drosglwyddir
ride	farchog
month	mis
telling	hadrodd
flights	teithiau
smokers	ysmygwyr
france	Ffrainc
elderly	henoed
present	rhoesent
lots	lotiau
hear	clywent
lobby	lobïwyd
comforts	cysuron
scam	sgam
meet	cwrddent
procedures	gweithdrefnau
need	angen
girl	merch
talking	siarad
hamburger	hamburger
happiness	hapusrwydd
hoped	gobeithio
streetside	strydoedd
casino	casino
acceptable	dderbyniol
due	yn ddyledus
pleasure	phleser
volvereta	Vololeta
behind	tu ôl
customer	gwsmeriaid
unexpected	annisgwyl
important	mhwysig
street	stryd
features	Nodweddion
anywhere	unrhyw le
south	atall
damage	difrod
interested	diddordeb
channels	sianelau
foreign	nhramor
land	glaniwyd
have	cael
scale	ddringent
over	drosodd
downtown	Downtown
starting	gychwyn
choice	dewis
age	heneiddio
ihad	ddymunol
paper	papur
directions	cyfarwyddiadau
compact	compact
crazily	chraziled
case	achos
ago	yn ôl
destination	gyrchfan
spend	dreuliwn
animations	animeiddiadau
cultures	diwylliannau
helpfull	Helpfull
supermarket	archfarchnad
going	mynd
my	fi
thursday	dydd Iau
bass	fas
2012	2012
old	hen
needs	hanghenion
holes	tyllau
robe	ngwreiddiau
helping	Helpu
âm	â € ™ m
vas	chi
least	lleiaf
bread	bara
contemporary	chyfoes
forum	fforwm
shous	esgidiau
spent	dreuliwyd
travelodges	travelges
rer	rhuthrwch
higly	higly
twin	gefeilliaid
trash	sbwriel
house	tŷ
river	afon
domicile	domisil
chair	cadair
possibilties	posibiliadau
thomsons	Thomsons
look	edrych
equipment	offer
vineyards	gwinllannoedd
simplistic	syml
haque	hac
adjacent	gerllaw
funny	ddoniol
days	dyddiau
want	am
bacteria	facteria
yourself	chi'ch hun
unclog	hanclog
complaint	cwynion
replinished	ailgyflenwi
bike	feic
pull	dyn
nadia	Nadia
diversity	hamrywiaeth
bugs	bygiau
rotten	pwdred
scrambled	sgramblo
iron	haearn
us	ni
frankfurtter	Frankfurter.
builnding	adeiladau
rock	creigiau
secure	sicrhânt
renewed	hadnewyddedig
comparing	cymharu
gone	syr
fairly	teg
registration	chofrestriad
review	hadolygir
apart	ar wahân
bussiness	bussiness
chic	chic
bloody	gwaedlyd
playing	chwarae
twist	gwyrdrôm
accommodation	llety
honeymooners	mêl
offered	chynigiwyd
professionell	phroffesiynol
who	Sefydliad Iechyd y Byd
explore	archwiliwch
delicacies	danteithion
azerbaijan	Azerbaijan
hall	neuadd
tidy	daclusent
westminster	San Steffan
pools	pyllau
track	dracian
egg	wy
pension	bensiwn
concerning	yn ymwneud
biggest	mwyaf
despite	er gwaethaf
surf	brigdorri
cooks	cogyddion
300	300
exchanging	cyfnewid
holidys	gwyliau
halles	helles
breaks	egwyliau
especialy	yn arbennig
delighed	wrth ei fodd
tram	dramâu
renovated	hadnewyddedig
mistake	camgymeriad
absolute	absoliwt
likely	debygol
discounts	ngostyngiadau
offer	hoffryd
continue	pharhaent
pleaseure	phleser
once	unwaith
arrival	chyrraedd
knowledge	gwybodaeth
quite	hollol
people	pobl
destinations	cyrchfannau
myself	fi
jaccuzzi	jaccuzzi
normally	fel arfer
sleep	cysgu
facilities	cyfleusterau
stays	yn aros
location	lleoliad
tastes	blasau
daily	dyddiol
became	daeth
cannot	ni all
package	pecyn
afterwards	wedyn
thrown	taflu
rose	Rhosyn
we	ni
remember	gofien
profession	proffesiwn
studio	stiwdio
golf	golff
hence	felly
booking	harcheb
backing	nghefnogaeth
piece	ddarnau
wasnt	nghones
cuddle	cwtsiwch
simply	yn syml
midnight	canol nos
staffs	Staffs
taking	chymryd
mangers	rheolwyr
sit	eistedded
kindness	charedigrwydd
aforesaid	uchod
holiday	gwyliau
bonus	bonws
better	gwell
walking	cerdded
she	hi
gladly	yn falch
competences	cymwyseddau
everybody	pawb
things	pethau
satisfied	fodlon
elysees	Elysesees
support	gefnogent
dat	Sef
baku	baku
spakenburg	Spakedburg
cafe	caffi
please	ryngwch
disappointed	siomedig
eat	fwyta
guests	Gwesteion
childrens	plant
smile	gwenwch
receptionists	Derbynyddion
read	darllenwyd
duck	ddowcied
heart	calonnau
spirits	ysbrydion
known	hysbysus
frequent	mynychwch
structure	strwythur
online	ar-lein
problem	mhroblem
tuscany	Tuscany
among	Ymhlith
expensive	drud
must	Rhaid
scandic	sganog
doing	wneud
actual	gwirioneddol
faulty	ddiffygiol
barcelona	barcelona
subway	isffordd
assorted	hamrywiol
playground	chae chwarae
nationality	cenedligrwydd
checkouts	tiliadau
november	Tachwedd
preciseness	anymebrwydd
care	ofalaf
egypts	Aifft
zone	parth
more	mwy
hospitality	lletygarwch
fresh	ffres
conected	chysylltiedig
boutiques	boutiques
swim	nofiwch
deira	deira
person	mherson
3am	nghyffredinol
ignorant	anwybodus
life	fywyd
credit	gredyd
job	swydd
airport	maes Awyr
shadows	cysgodion
these	rhain
gave	roddwyd
because	oherwydd
angry	dig
1mile	1mile
2010	2010
hotelmanager	gwestywr
inclysive	gynhwysol
incredibly	anhygoel
really	go iawn
together	gyda'i gilydd
par	drwodd
276	276
too	hefyd
lord	arglwyddiaethir
situation	sefyllfa
happened	Digwyddodd
wear	dreulies
maximum	uchafswm
stupid	dwp
why	pam
fridge	oergelloedd
th	th
decent	gweddus
infrastructure	isadeiledd
suit	thrawiad
marinachania	marina
layout	chynllun
luxurious	moethus
miami	miami
pretty	noethach
load	llwytho
our	ein
you	chi
immidiately	ar unwaith
extended	hymestyn
apartment	fflat
oasis	gwerddon
restaraunts	bwytai
marriott	Marriotties
issue	mater
supported	cefnogi
pub	tafarn
visited	ymweld
mainly	yn bennaf
anybody	unrhyw un
getaway	getaway
variuos	amrywiol
centrally	yn ganolog
vivaldi	vivaldi
turkey	twrci
behold	wele
choises	newisiadau
visit	gwelant
15	15
alphons	halpweithiau
information	gwybodaeth
heaven	nefoedd
favourite	hoff
tower	tŵr
active	egnïol
office	swyddfa
frills	frills
yes	ie
certainly	Yn sicr
c	c
hope	gobaith
left	chwith
fact	ffaith
miles	milltiroedd
deprived	ddifreintiedig
cusines	cuisines
months	mis
specially	yn arbennig
tip	tip
great	wych
olso	olso
cleaners	glanhawyr
backpackers	Backpackers
could	a allai
meal	brydoedd
me	fi
dame	ddeiawch
train	thrên
perfect	perffeithiaf
acoustic	acwstig
families	nheuluoedd
at	hwy
climb	dringan
2nd	Ail
like	hoffech
sri	sri
between	rhwng
experienced	profiadol
unconfortable	anghyfforddus
gift	rhodd
inn	thafarnau
they	nhw
summary	crynodeb
highlights	uchafbwyntiau
since	gan
family	nheuluoedd
working	weithio
inner	fewnol
guest	gwestai
excusive	drychinebus
afew	Afew
thick	drwchus
business	busnes
tea	te
genuine	ddilys
heating	gwres
outstanding	rhagorol
hosts	gwesteion
taxi	tacsi
possibly	o bosibl
video	fideo
utrecht	Utrecht
og	a
staying	aros
classiest	glasaf
interesting	diddorol
milk	olid
budget	nghyllideb
climbing	dringo
hip	glun
cold	oer
ancient	hancient
dansing	dawnsio
swans	wyriadau
usd	doler yr UDA
everywhere	ym mhob man
nights	nosweithiau
dec	ragbrofent
goggle	goggle
explain	eglurai
stares	syllu
many	llawer
cuisine	cuisin
environment	Amgylchedd
order	archeba
weren	ward
manicured	hanfodus
verz	pennill
dish	ddysgl
children	plant
â	â € ™
stopped	hanfon
offering	cynnig
crazy	gwallgof
thoroughfare	niffyg
mgmt	mgmt
itself	ei hun
maid	morwyn
courses	cyrsiau
return	ddychwelom
euro	ewro
brilliant	gwych
aquagym	aquagym
reply	hateb
restricted	gyfyngedig
disclosed	datgelu
shoes	esgidiau
excellent	rhagorol
made	a wnaed
won	enillwyd
charme	gyfaredd
deventer	Deventer
choices	newisiadau
expect	ddisgwylied
call	galw
appreciate	werthfawrogwyd
petros	petros
bookingcom	Bookingcom
yard	iard
grandaughter	nengach
under	dan
thank	ddiolch
surprisingly	rhyfeddol
am	yn
around	o gwmpas
recommend	argymhellant
kindly	garedig
7th	Cwt
sea	fôr
hearts	nghalonnau
how	Sut
march	gorymdeithiau
restful	gorffwys
moved	Symud
money	arian
di	o
self	hunan
complain	gwynaf
impossible	amhosibl
drain	draen
spoken	lafar
refurnished	hail-ddurniwyd
lake	lyn
personal	mhersonol
tourists	twristiaid
swimmingpools	pyllau nofio
2014	2014
usual	arferol
persistent	nghyson
ample	amddig
loud	uchel
stag	stag
function	swyddogaeth
while	tra
dubai	dubai
therefore	felly
hostess	hostelaethau
totally	yn llwyr
possibility	posibilrwydd
ok	iawn
excelent	yn eithriadol
mohamed	Mohammed
size	maint
comprehensive	cynhwysfawr
min	fi
dj	dj
safisfied	fodlon
aerea	erial
english	Saesneg
example	enghraifft
seats	seddau
unhappy	anhapus
speed	chyflyment
base	sylfaenaf
bedroom	ystafelloedd gwely
other	arall
away	i ffwrdd
holidaymy	hapchwarae
then	bryd
welcome	croesawed
greatincredible	hanwiradwy
bad	ddrwg
pathã©	PATHA ©
expected	ddisgwyliedig
adult	oedolyn
awesome	anhygoel
reception	nerbynfa
whenever	pryd bynnag
attendance	phresenoldeb
eurostars	Eurostars
climation	hinsiad
boat	cwch
back	gefn
long	dyhea
refund	had-dalwch
vodka	fodca
marvelous	rhyfeddol
amp;	amp;
positive	cadarnhaol
village	bentref
helpfulathe	Helpfulahe
low	isel
noticeable	amlwg
wireless	di-wifr
legs	coesau
avoid	hepgorent
nothing	dim
pleases	plesio
colorful	lliwgar
candy	candy
road	raff
take	gymeron
invite	gwahoddwyd
seaside	glan môr
pizzeria	pizzeria
serious	ddifrifol
lift	codwch
stress	straeniff
impressions	hargraffiadau
tide	llanw
allows	yn caniatáu
just	ni
basin	basn
heater	gwresogydd
healthy	iach
needed	sydd ei angen
swiming	nofio
george	george
disadvantages	anfanteision
space	gofod
negative	negyddol
done	a wnaed
underconstruction	tangyflogaeth
wil	eisiau
london	Llundain
storage	storfa
shabby	dilledyn
entire	cyfan
request	gais
again	eto
trailer	trelar
american	Americanaidd
tried	geisio
having	cael
hurghada	hurglada
eurostar	Eurostar
slippers	sliperi
friendy	nghyfeillgar
can	chanian
pot	phocedir
reasonable	rhesymol
his	ei
vehicles	gerbydau
rambla	rambla
until	tan
olive	olewydd
some	rhai
near	ger
visible	weladwy
spacious	eang
peoplethe	pobl
attending	mynychu
serve	gwasanaethwch
completely	yn llwyr
smsevery	smsecase
weekends	penwythnosau
arrivals	cyrraedd
enough	digon
cleaness	glendid
sell	gwerthu
cheese	caws
breakfast	frecwast
steak	stêc
mountains	mynyddoedd
firenze	Flodau
railway	rheilffordd
neatly	daclus
efficient	effeithlon
front	blaen
timely	hamserol
knew	hadnabu'n
hotelthe	Gwesty'r
actually	mewn gwirionedd
receptionist	derbynnydd
services	gwasanaethau
times	hamserau
out	allan
certain	sicr
re	r
owners	perchnogion
requests	Ceisiadau
sercices	gwasanaethau
downstairs	i lawr y grisiau
tanning	lliwiau
far	pellaf
rules	rheolau
bubba	bubba
putting	gosod
standards	safonau
decorated	haddurno
interior	tu mewn
waiter	weinydd
trees	nghoed
position	sefyllfa
asian	Asiaidd
ridiculous	chwerthinllyd
upper	uchafach
colleagues	cydweithwyr
yoghurt	iogwrt
quickly	gyflymaf
rate	drethwyf
stone	garreg
roadside	ymylol
country	ngwlad
royalty	freindal
coming	ddod
busy	prysur
center	nghanolfan
cottage	fwthyn
kettle	tegell
ia	ef
generally	yn gyffredinol
garden	garddiff
mini	mini
throw	taflu
able	galluog
stolen	ddwyn
3rds	3rdod
cheap	rhad
seeing	ngweld
unfortunately	Yn anffodus
houses	tai
suite	hystafelloedd
amination	aminiad
snorkeling	snorcelu
pleasant	bleserus
interest	ddiddoraf
carparking	pharcio
amount	swm
side	ochr
special	arbennig
rain	glawiff
enterainment	adloniant
code	côd
dolphin	dolffiniaid
described	a ddisgrifir
curtains	llenni
respects	parch
definitely	yn bendant
eg	Ee
free	am ddim
informed	hysbysus
two	dau
lounge	lolfa
nord	Gogledd
rimini	rimini
guys	guys
vitosha	fitosha
place	rho
appart	ngwastad
program	raglennu
steakhouse	steakhouse
reasons	resymau
axaha	elb
careful	ofalus
coktailsstaff	coktailsstaff
massive	enfawr
fingerprints	olion bysedd
canine	nghanwydd
step	camon
handled	haneled
claiming	Hawliad
trimphe	thriomphe
brits	prits
already	eisoes
bars	barrau
highway	phriffyrdd
welcomewould	Croeso
5	5
games	gemau
strongly	yn gryf
lousy	lousy
de	o
noise	sŵn
asked	gofynnwyd
located	hysgogi
friendliness	cyfeillgar
sheets	nhaflenni
pants	pants
night	nosweithiau
cleanliness	glendid
per	am
paying	thalu
inside	tu mewn
allow	ganiatáu
note	Nodyn
relaxed	ymlaciedig
8th	8fed
europe	Ewroped
smart	chraffach
loveliest	hyfynaf
should	dylai
comfort	cysuraf
pluss	chi
improved	gwell
leisure	Hamdden
madrid	madrid
paris	pharis
octoberfest	oktoberfest
lagune	lagŵn
vast	enfawr
30th	30ain
joy	lawenydd
charm	gyfaredd
resorts	cyrchfannau
maybe	Efallai
400	400
florence	flodau
get	dda
its	ei
looking	edrych
sunbeds	gwelyau haul
overpriced	orbrisio
poland	Gwlad Pwyl
cracked	chwâl
carpet	ngharped
stained	staeniedig
feel	synhwyrent
real	go iawn
holidays	gwyliau
bridge	bontiaf
countryside	nghefn gwlad
smiles	wên
sky	hawyr
amasing	yn hynod
mean	gymedrau
see	gwelent
stuff	sachwch
brought	ddygir
cereal	grawnfwydydd
april	mis Ebrill
not	nid
decided	phenderfynwyd
dogs	cŵn
radio	radio
ât	â € ™ t
else	arall
black	ddu
attractive	ddeniadol
powerful	pwerus
dinner	cinio
connect	cysylltasent
holland	holand
the	y
planning	chynllunio
verry	feryn
nite	nite
eyesi	Llygadwch
buy	brynwyf
boy	fechgyn
began	dechreuodd
conditioning	gyflyru
surely	yn sicr
items	eitemau
fi	fydd
originally	yn wreiddiol
leaking	gollwng
surprise	syndod
polite	gwrtais
awful	ofnadwy
louvre	louvre
institute	sefydlont
young	ifanc
dance	ddawns
police	plismona '
run	rhedwch
palace	mhalasau
idem	yr un
jacuzzi	jacuzzi
blonde	blonde
bathrooms	ystafelloedd ymolchi
wc	wc
television	nheledu
claustrophobic	clawstroffobig
vieuz	vieuz
otherwise	fel arall
best	gorau
window	ffenestr
fit	ffitiais
wg	yn
high	uchel
phone	ffôn
âs	â € ™ s
reality	realiti
find	ddarganfyddaist
about	am
schiphol	schiphol
lunch	nghinio
years	flynyddoedd
ever	byth
worst	gwaethaf
several	nifer
world	fyd
evening	nosweithiau
miss	colled
unacceptable	annerbyniol
middle	nghanol
beginning	dechrau
elegant	geiniog
executive	weithredwyr
state	ngwladwriaeth
helpful	ddefnyddiol
minibar	minibar
summer	hafest
villa	fila
beaituful	Hardd
sharm	sharm
smooth	lyfnhaent
chipped	chiped
steep	serth
didn	didn
gym	Campfa
toast	crasir
cruise	fordaith
accommodating	llety
smiling	gwên
machine	peiriant
whisky	wisgi
oliver	oliver
tuscan	tuscan
reservations	amheuon
seine	ei
skype	skype
fountain	ffynnon
repair	atgyweirir
tp	tp
traffic	draffig
exact	union
seven	saith
possitive	bositif
foor	foor
hamam	bath
food	bwyd
possible	phosibl
mega	mega
wanted	am
central	nghanolog
easily	yn hawdd
new	newydd
first	yn gyntaf
elysee	elysee
connection	cysylltiad
sneaky	sneaky
resort	cyrchfan
egypt	yr Aifft
tasty	flasus
service	gwasanaeth
men	dynion
reached	chyrhaeddwyd
drink	ddiod
perfekt	Perffeithiaf
experience	brofwyd
relax	hymlaciwch
minus	minws
columbus	columbus
boys	fechgyn
still	llonyddaf
well	dda
last	parhaed
soon	fuan
noisy	swnllyd
tha	mi wnaf
feeling	deimladau
flughaven	Maes Awyr
advertised	hysbysebion
affordable	fforddiadwy
catered	darperir
delightful	hyfryd
blocks	flociau
wilderness	anialwch
coffee	coffi
spa	sba
dated	dyddiedig
mother	fam
jammed	hamhri
directly	yn uniongyrchol
spending	gwariant
cause	parir
stop	harnaf
humid	llaith
orders	gorchmynion
favorite	hoff
set	fachludent
siena	siena
feels	yn teimlo
provides	ddarperir
time	hamser
weekenders	Penwythnosau
foyer	foyer
refrigerator	oergellwr
cook	coginiwch
liked	yn hoffi
koln	koln
admire	hedmygwyd
oberoi	oberoi
trier	trier
wall	wal
luxuries	foethusrwydd
120	120
bliss	mhless
flamenco	fflamenco
mobile	Symudol
speak	hyngan
received	derbyn
hours	oriau
en	yn
windows	ffenestri
surroundings	hamgylchedd
unbelievable	hanghredadwy
overal	ym mhob man
cuase	parir
accomodation	lety
tag	tag
butt	bôn-uniff
fee	ffi
grill	gridyll
varied	hamrywiol
disclose	ddadlennwch
through	drwodd
altstadt	altstadt
it	ef
disadvantage	anfantais
gilde	urdd
basic	syml
situated	lleoli
is	yw
lights	ngoleuadau
hilton	hilton
entertain	ddifyrra
continental	cyfandirol
let	gadawent
160	160
spotlessly	ddi-ben-draw
work	gweithiwn
easy	hawdd
fine	ddirwy
manner	ddulliau
literally	yn llythrennol
luxurous	moethus
rum	rym
luggage	bagiau
pompidou	pompidou
1st	1af
disaster	drychineb
germans	Almaenwyr
every	phob
corner	nghornel
aren	n
tell	ddywed
express	fynegwch
jam	jamiwn
team	dîm
different	gwahanol
such	megis
trousers	trowsus
covered	dan sylw
early	cynnar
ours	ni
hotel	gwesty
key	allwedd
toiletries	phethau ymolchi
plage	Draeth
territory	diriogaeth
recommendations	argymhellion
ship	llong
association	chymdeithasau
trying	geisio
interestingin	Diddorol
pluspoint	Mwy
happy	hapus
don	don
paied	bopethwch
highly	hynod
number	rhif
unpleasantness	annifyrrwch
european	Ewroped
ideally	yn ddelfrydol
kind	caredig
leave	gadael
peopel	pobl
disgusting	ffiaidd
reservation	harchebion
instead	yn lle hynny
calimera	calimera
sablon	Argraffu Sgrin
meetings	nghyfarfodydd
therethank	Thathank
most	fwyaf
akward	lletchwith.
prompt	gofweiniwyd
robbed	ddwyn
kitchen	cegin
minute	munud
alternation	alternation
elina	elina
superb	wych
members	aelodau
carlton	carlton
groups	grwpiau
their	eu
vacationpickalbatros	VacationPickalbatros
freezing	rhewi
regard	sylw
minded	meddylgar
hof	hof
notre	ein
inedible	anghyfannedd
premises	mangreoedd
8	8
scenic	golygfaol
confirmation	chadarnhad
deal	ddeliff
restaurat	hadferiadau
however	Fodd bynnag
up	hyd
conference	cynhadledd
titanic	titanaidd
website	gwefan
7	7
finished	gorffenedig
espresso	espresso
b	b
tv	teledu
snorkelling	snorcelu
dirty	drochaf
periferique	perifferique
living	byw
inexpensive	rhad
pubs	tafarnau
alone	ymiried yn unig
date	ddyddiwyd
parts	rannau
passing	pasio
wheel	olwyni
feb	nheb
warm	cynhesaf
croissants	croissants
thoroughly	drylwyr
tiling	nheilsiaid
by	gan
luxury	moethus
addition	ychwanegiadau
spaciousthe	spaciousthe
building	adeiladau
convention	confensiwn
unlike	annhebyg
light	ngolau
quicker	gynyddol
isolation	ynysu
linked	chysylltiedig
lighting	ngoleuadau
outside	tu allan
swimming	nofio
likewise	yn yr un modd
hopping	hercian
break	torrwch
ll	ll
educated	haddysgedig
coach	hyfforddai
gaps	fylchau
know	hadnabydded
pizza	pizza
exceptional	eithriadol
were	oedd
period	cyfnodau
extrasthe	Hychod
chill	oera '
rail	rheilffyrdd
quality	hansawdd
build	choded
connected	chysylltiedig
mice	llygedyn
entrance	fynedfa
furnished	ddodrefnus
both	y ddau
that	hynny
cleanest	nglanaf
requires	mai
italien	Yr Eidal
option	opsiwn
sasha	sasha
opera	opera
90	90
passed	pasio
dirt	faw
anyone	unrhyw un
he	ef
manager	rheolwr
stations	gorsafoedd
hospitable	chroesawgar
empty	gwacáu
travelodge	thravelodge
internet	rhyngrwyd
pleasantly	hyfryd
sã¶dermalm	Sã¶dermalm
off	oddi ar
residential	phreswyl
bring	ddygan
nicest	nicest
selection	ddetholiad
dust	llwch
cigarette	sigaréts
nearby	gerllaw
terrace	teras
fitness	ffitrwydd
surrounding	amgylchynol
;	;
anything	unrhyw beth
niuewstraat	Niuuewstraat
choose	dewisir
channel	sianel
exceptionally	yn eithriadol
built	hadeiladau
took	chymynnwch
sunny	Heulog
meat	gig
got	got
oversee	goruchwyliaf
ration	ddogni
commonly	cyffredin
signal	harwyddaf
pintxos	pintxos
mountain	fynydd
rest	gorffwysaf
linen	liain
used	a ddefnyddiwyd
said	Dywedodd
course	cwrs
chaos	anhrefn
decoration	addurno
value	gwerthfawrogi
exceeded	yn uwch na
respective	priodol
complaints	cwynion
relaxing	ymlacio
french	Ffrangeg
faded	faded
wooden	pren
weather	dywydd
recomended	hailadrodd
stay	aros
gold	aur
miro	miro
cross	groesaf
accustomed	yn gyfarwydd
class	nosbarth
your	eich
customers	cwsmeriaid
york	Efrog
timing	hamseriad
namely	sef
marvellous	rhyfeddol
milano	milano
large	mawr
soap	sebon
access	fynediad
flag	lumaniff
check	gwiriwch
game	ngêm
nes	fel
couples	cyplau
hole	twll
fish	bysgoti
card	cribwch
quiet	thawelach
haven	hafan
ms	Ms
think	meddwl
worse	waeth
them	nhw
weekend	penwythnosau
e	e
sports	chwaraeon
lyon	lyon
kinds	fathau
junior	iau
animation	animeiddiad
desired	ddymunedig
outdated	hen ffasiwn
sauna	sawna
use	harfer
lanxess	lnixess
february	mis Chwefror
pay	thalent
reach	chyrhaeddwyd
dishes	seigiau
wellness	les
revisiting	ailymweld
suprise	syfrdwn
convenient	gyfleus
whose	pwy
believe	credwch
underground	danddaearol
apartments	fflatiau
unique	unigryw
impression	hargraff
flat	fflat
somewhat	rhywfaint
without	heb
siro	siro
â	â € "
urine	wrin
takes	chymryd
doesen	dabsen
so	felly
queue	ciwied
being	bod
realy	rawn
topaz	topaz
attitude	agwedd
woerden	woerden
give	rho
pass	tramwyent
i	i
terrific	ardderchog
heard	clywed
name	henwaist
rates	cyfraddau
design	ddylunies
photos	lluniau
six	chwech
local	lleol
vacation	wyliau
might	a allai
passport	pasbort
dusting	llithriad
enjoy	mwynhau
sorted	didoled
touchwith	touchwith
amsterdam	hamsterdam
dorm	dorm
okay	iawn
walls	waliau
whole	cyfan
outlet	offrymau
pantaneto	Pantaneto
points	bwyntiau
alley	ali
start	dechrau
safe	ddiogel
four	pedwar
gare	gorsaf
repeatative	ailadroddus
breathtaken	hanadledig
conditions	hamodau
10m2	10M2
dirtyour	drochi
love	garwyd
marseillan	marsilan
partner	bartner
worked	gweithio
no	na
thing	peth
san	san
happily	yn hapus
yaer	Sefydliad Iechyd y Byd
system	system
restaurant	fwyty
cope	ymdoped
confusing	ddryslyd
weeks	wythnosau
recommended	hargymell
another	un arall
one	un
week	wythnos
provide	ddarperir
swimmingpool	pwll Nofio
market	marchnata
ready	barod
rooms	ystafelloedd
forward	hymlaen
fitnes	ffitrwydd
modern	modern
narrow	gulhaed
included	chynwysedig
ask	gofynnon
means	yw
montjuic	montjuic
towels	tywelion
invited	a wahoddwyd
cost	costiwn
spacy	sbeisys
painting	paentiad
camp	campiwn
kids	mhlant
hi	hi
type	teipiwch
immaculately	yn ddiymhongar
charming	swynol
enmenons	Metron
beach	draeth
buses	fysiau
complained	gwynaf
steps	grisiau
boulevar	boulevar
all	I gyd
management	rheolaeth
martha	martha
normal	normal
ad	ad
funiture	dodrefn
seems	welaf
highways	priffyrdd
options	opsiynau
visits	ymweliadau
diffrent	diffrwd
picky	picky
especially	yn arbennig
anyway	beth bynnag
700	700
rungis	rungis
shopping	siopa
leaving	Gadael
recently	yn ddiweddar
proffesional	phroffesiynol
arranged	trefnwyd
using	gan ddefnyddio
private	phreifat
shame	gywilydd
cocktails	coctels
idea	syniadau
what	beth
dress	gwisgan
car	car
than	na
gets	gânt
surprising	syndod
fabulous	wych
cake	gacen
attitudes	hagweddau
table	bwrdd
try	trig
plus	chi
gardens	ngerddi
downside	anghysbell
modest	cymedrol
wide	eang
â¬	â ,¬
dark	tywyll
rent	rhent
reviews	adolygiadau
stops	stopio
those	hynny
relations	nghysylltiadau
streets	strydoedd
five	pump
century	ganrif
spreads	taeniad
workers	gweithwyr
enter	rhagamynnir
dream	freuddwydiont
insulation	inswleiddio
organization	sefydliad
had	wedi
byron	byron
welcomed	croeso
terrible	dreiddgar
spoilt	difetha
cool	cwl
during	yn ystod
hang	hongiwch
couldn	ni allai
full	pannent
hade	wedi cael.
twice	ddwywaith
insisted	mynnodd
beaches	traethau
across	ar draws
partying	barti
insects	pryfed
kuku	hoelio
unclear	aneglur
conveniently	gyfleus
mould	fowldiaf
builders	adeiladwyr
felt	ffeltiais
from	o
pond	pwll
75	75
waiters	gweinyddwyr
reason	rhesymir
walkways	llwybrau cerdded
broken	thorri
went	aeth
anna	anna
blend	cymysgu
unless	oni bai
