arc	ADJ
biggest	ADJ
budget	NN
destination	NN
walls	NNS
bar	V
ready	ADJ
expectations	NNS
smell	V
fantastically	ADV
generally	ADV
swimmingpool	ADJ
soap	NN
dancers	NNS
foreign	ADJ
between	IN
euro	ADJ
premises	NNS
into	IN
lake	ADJ
happily	ADV
provides	V
twist	NN
it	PRP
rate	NN
lighting	V
left	V
express	ADJ
beaituful	NN
complained	V
amination	NN
decoration	NN
minded	V
awesome	ADJ
cloth	NN
turkey	NN
surprised	V
pizzeria	NNS
believe	V
butt	NN
definitely	ADV
feb	V
higher	ADJ
disadvantage	NN
lots	NNS
bridge	V
name	NN
info	NN
groups	NNS
unfortunately	ADV
rail	V
relax	ADJ
cinema	ADJ
opinion	NN
spoiled	V
dolphin	ADJ
professionell	NN
denmark	NN
oliver	NN
use	NN
noice	ADJ
heavily	ADV
problem	NN
moments	NNS
linked	V
accustomed	ADJ
terrace	NN
decorative	ADJ
bathing	NN
wonderful	ADJ
hope	NN
smile	ADV
much	ADJ
foor	NN
point	NN
couple	NN
bring	V
friends	NNS
comparing	V
jaccuzzi	ADJ
streets	NNS
par	V
son	NN
seems	V
stuck	ADJ
6	CD
dorint	NN
ample	ADJ
studio	NN
passed	V
cuddle	ADJ
7	CD
belongings	NNS
wooden	ADJ
following	V
mostly	ADV
italian	ADJ
non	NN
modern	ADJ
traveling	V
arena	ADJ
meals	NNS
letdown	ADJ
storage	NN
smelt	V
don	ADV
famous	ADJ
tee	NN
ð¢his	NNP
efficiently	ADV
cold	V
pantaneto	NN
flight	NN
else	ADV
superb	ADJ
egypt	NN
tag	NN
leaking	V
tallinn	ADJ
land	NN
blue	IN
her	PRP$
pond	NN
boulevar	NN
cultures	NNS
touristy	V
bathtub	NN
prefect	NN
takes	V
lot	ADV
many	ADJ
5	CD
construction	NN
chance	NN
admire	NN
means	V
revisiting	V
skype	ADJ
correspond	NN
unmatched	V
restourant	ADJ
espaccely	ADV
relatively	ADV
public	ADJ
issue	NN
hostess	NN
charm	NN
pompidou	NN
mistakes	NNS
helpful	ADJ
intersection	ADJ
tv	NN
second	V
itself	PRP
etc	FW
couldn	FW
metro	FW
cleaning	V
2014	CD
heater	NN
languages	NNS
ms	V
absolute	ADJ
dana	NN
elegant	ADJ
package	NN
theres	NNS
credit	NN
area	NN
map	NNS
nor	CC
within	IN
keys	NNS
somewhat	ADV
canal	ADJ
dislike	NN
stayed	V
charged	V
dansing	V
cost	NN
sray	NN
respects	V
anyway	ADV
3am	CD
talking	V
round	NN
singles	NNS
beds	V
coktailsstaff	ADJ
shopping	V
minibar	NN
cheap	ADJ
persons	NNS
nearby	ADV
passing	V
lobby	NN
underground	NN
directly	ADV
products	NNS
conclusion	NN
tasty	ADJ
mean	ADJ
thick	NN
de	IN
remind	FW
reef	NN
girl	NN
seats	NNS
deal	V
line	NN
kallithea	NN
wg	NN
visited	V
checked	ADJ
visit	NN
toast	IN
few	ADJ
smiles	NNS
lamps	V
petros	NNS
allowing	V
sell	V
helpfulathe	NN
till	NN
10m2	CD
leisure	NN
chef	NN
emily	ADV
speaking	V
vacation	NN
however	ADV
cigarrum	ADJ
holiday	NN
spreads	NNS
complain	V
marseillan	ADJ
speed	NN
adults	NNS
typical	ADJ
restricted	V
th	ADV
created	V
persistent	ADJ
avoid	ADJ
bliss	NN
smiling	V
domicile	ADJ
olive	ADJ
selection	NN
space	NN
creaky	NN
residents	NNS
sastisfied	V
advise	NN
brussels	NNS
extremly	V
afterwards	NNS
houses	NNS
european	ADJ
sea	NN
july	NN
locate	V
am	V
4	CD
boy	NN
leaving	V
quiet	ADJ
prompt	ADJ
altstadt	NN
due	ADJ
life	NN
issues	NNS
7th	CD
more	ADJ
recommendation	NN
expensive	ADJ
iron	NN
on	IN
around	IN
bacteria	NNS
painting	V
in	IN
willing	ADJ
maybe	ADV
delivery	NN
experienced	V
heating	V
trouble	NN
mountain	NN
timing	V
dirty	NN
costlier	NN
february	ADJ
boys	NNS
recommendable	ADJ
steigenburger	ADJ
lounge	NN
four	CD
fitnes	NNS
buildings	NNS
will	MD
wall	V
gran	NN
accommodating	V
parts	NNS
load	NN
basin	NN
system	NN
cusines	V
wireless	ADJ
police	NNS
safety	NN
program	NN
liverpool	NN
conference	NN
restaurants	NNS
easily	ADV
score	ADV
afew	ADJ
cuase	NN
utrecht	NN
lost	V
colorful	ADJ
unforgettable	ADJ
done	V
climation	NN
originally	ADV
attention	NN
rooms	NNS
2013	CD
tele	ADJ
surprisingly	ADV
became	V
exceeded	ADJ
russians	NNS
early	ADV
unacceptable	ADJ
literally	ADV
paid	V
mother	NN
fitness	NN
wait	NN
late	ADV
size	NN
they	PRP
enter	V
gym	ADJ
lift	NN
happy	ADJ
buses	NNS
prefer	V
fish	ADJ
down	RP
attitude	NN
welcoming	V
cars	NNS
downside	ADJ
tram	NNS
leave	V
so	ADV
length	ADJ
change	NN
won	V
advantage	ADJ
animation	NN
wil	NN
tasteswe	NN
supermarket	NN
varied	V
seven	CD
those	DT
reached	V
flower	NN
offer	NN
brought	V
attitudes	NNS
touring	V
suprise	NN
adult	NN
indeed	ADV
entertainment	NN
american	ADJ
driving	NN
floaties	NNS
gold	V
brocken	V
balu	ADJ
comfortablelounge	NN
downstairs	NNS
mention	NN
pleasure	NN
ideally	ADV
beware	ADJ
gare	NN
stars	NNS
preciseness	V
holidays	V
700	CD
elysees	NNS
outside	IN
institute	NN
pubs	NN
again	ADV
min	ADV
manicured	V
channel	NNS
different	ADJ
death	NN
top	NN
elderly	ADJ
sheraton	NN
such	ADJ
started	V
interior	ADJ
halles	NNS
extended	V
disabled	ADJ
two	CD
noticed	ADJ
style	NN
above	IN
rimini	NN
fast	NN
pirates	V
nights	NNS
idea	NN
steps	NNS
whenever	WRB
base	NN
alive	ADJ
garden	NN
yourself	PRP
step	V
april	ADV
peoplethe	ADJ
niuewstraat	NNS
food	NN
month	NN
came	V
breathtaken	V
playground	NN
older	ADJ
taste	NN
300	CD
used	V
almost	ADV
assoiated	ADJ
aquagym	NN
peopel	NN
stopped	V
extreme	ADJ
standards	NNS
worth	ADJ
full	ADJ
replinished	V
kettle	ADJ
jacuzzi	NN
fantastic	ADJ
waits	NNS
equipped	V
tip	ADJ
diffrent	NN
holes	NNS
able	ADJ
lord	NN
og	V
totally	ADV
vips	ADJ
double	ADJ
yes	NNS
keep	V
recommend	NN
miss	ADJ
enough	ADV
amel	NN
customers	NNS
care	V
architecture	ADJ
normally	ADV
pleasant	V
liable	ADJ
yet	ADV
fingerprints	NNS
november	V
siro	ADJ
phone	NN
hotelmanager	NN
tha	NN
you	PRP
hard	ADJ
by	IN
queue	ADJ
always	ADV
hot	V
;	:
renovated	V
oasis	NN
aforesaid	V
sure	ADJ
most	ADV
canine	ADJ
facilties	NNS
spaciousthe	V
new	ADJ
uncomfortable	ADJ
elevator	NN
really	ADV
event	NN
days	NNS
cologne	V
stops	ADJ
feast	ADV
make	V
impossible	ADJ
look	NN
dvd	NN
bike	NN
shame	NN
game	NN
near	IN
touchwith	NN
exchanging	V
frienly	ADV
immidiately	ADV
hall	ADJ
about	IN
attended	ADJ
smallest	ADJ
sewage	NN
straight	V
hi	NN
may	MD
diidn	V
to	TO
vieuz	V
possibilties	NNS
year	NN
providing	V
mould	MD
cancelled	V
shuttle	ADV
finished	ADJ
built	V
very	ADV
tornese	ADJ
roadside	NN
traffic	NN
high	ADJ
calimera	NN
old	ADJ
was	V
daytime	ADJ
tourist	NN
jam	NN
atmosphere	ADV
mountains	V
couples	NNS
jean	NN
prepared	V
topaz	ADJ
corridor	NN
tea	NN
pull	NN
but	CC
parking	V
tidy	ADJ
enthusiastic	ADJ
electrical	ADJ
noticeable	ADJ
we	PRP
real	ADJ
smaller	ADJ
too	ADV
track	ADJ
allows	NNS
wear	V
disadvantages	NNS
living	V
luxurious	ADJ
trees	NNS
proffesional	ADJ
thrown	ADJ
seen	V
antic	ADJ
rose	V
conveniently	ADV
met	V
les	V
18th	CD
friend	NN
bit	NN
mgmt	ADJ
taking	V
invited	ADJ
greatincredible	ADJ
completely	ADV
opportunitys	ADJ
build	NN
outstanding	ADJ
extra	ADJ
fine	ADJ
repeat	NN
5days	CD
close	ADJ
dj	NN
montjuic	NN
sri	NN
hip	NN
weather	NN
course	NN
especialy	ADJ
charme	V
other	ADJ
ia	ADJ
break	NN
castelo	NN
lights	NNS
team	NN
claiming	V
i	NN
window	V
ultra	ADJ
makers	NNS
start	V
expense	ADJ
water	NN
subway	NN
date	NN
hospitality	NN
manner	NN
off	IN
several	ADJ
reservations	NNS
end	V
tennisfriends	V
ours	ADJ
possitive	ADJ
funiture	NN
dine	NN
drain	NN
stores	NNS
boring	V
little	ADJ
staffs	NNS
egypts	V
moved	V
incredible	ADJ
price	NN
rambla	NN
absolutely	ADV
tastes	V
there	EX
robe	V
review	NN
fabulous	ADJ
freezing	V
club	NN
lifestyle	ADJ
cleanliness	NN
video	NN
recomended	V
customer	NN
beach	NN
type	NN
weeks	NNS
nicely	ADV
hour	NN
husband	NN
considering	V
behind	IN
apartment	NN
bad	ADJ
cleanest	NN
cleaness	NN
delighed	V
normal	ADJ
simply	ADV
say	V
looked	ADJ
foot	NN
cruise	NN
range	NN
pleaseure	NN
city	NN
versa	IN
someone	NN
now	ADV
scale	ADJ
every	DT
machine	NN
bathrobes	NN
light	ADJ
dutch	NN
comfortable	ADJ
wasnt	NN
disappointed	V
beautifully	ADV
favorite	ADJ
perfect	ADJ
boat	NN
nothing	NN
feels	NNS
35	CD
bussiness	NN
likewise	NN
gets	V
transfer	V
staircase	NN
train	NN
marinachania	NN
observations	NNS
order	NN
house	NN
wonderfull	V
defiantly	ADV
276	CD
mobile	ADJ
luxor	NN
what	WP
territory	NN
maker	NN
than	IN
work	NN
superfriendly	ADV
various	ADJ
allow	ADJ
pricey	NN
short	ADJ
unbelievable	ADJ
incredibly	ADV
supburb	ADJ
pitch	NN
attentive	ADJ
frankfurtter	NN
held	V
160	CD
conected	V
sunny	ADJ
disclose	V
paper	NN
simple	NN
90	CD
nite	ADJ
all	DT
regard	NN
solved	V
ask	ADJ
giant	ADJ
conditions	NNS
guests	V
30	CD
alanani	NN
vas	NN
schiphol	NN
amp;	IN
darling	V
en	ADJ
pleases	NNS
â	V
heaven	ADV
improved	V
competences	NNS
gardens	NNS
got	V
pm	ADJ
wasn	NN
situated	V
deter	ADJ
pity	NN
enjoyed	V
tables	NNS
black	ADJ
shous	ADJ
restrooms	NNS
acceptable	ADJ
miserable	ADJ
joy	NN
fashioned	V
welcomes	NNS
candy	ADJ
online	V
3rds	CD
mum	ADJ
partner	NN
rubber	NN
oversee	NN
alley	NN
request	NN
dishes	NNS
destroyed	V
deprived	V
ansd	ADV
need	V
unconfortable	ADJ
grand	ADJ
things	NNS
departure	NN
junior	ADJ
views	NNS
10	CD
tell	V
actually	ADV
treated	V
whose	WP$
kuku	NN
twin	NN
mega	ADJ
part	NN
sheets	NNS
me	PRP
similar	ADJ
overal	ADJ
italien	NN
home	NN
apart	ADV
stag	ADJ
transition	NN
big	ADJ
stupid	NN
its	PRP$
accommodation	NN
flights	NNS
milano	NN
vice	NN
support	NN
been	V
yoghurt	NNP
office	NN
marvelous	NN
laughed	V
worries	NNS
sunrise	V
nord	ADJ
door	NN
offered	V
noise	ADV
aldo	ADJ
genuine	NN
friendly	ADJ
tuscan	ADJ
example	NN
call	NN
sneaky	V
welsh	ADJ
free	ADJ
enmenons	NNS
took	V
minus	NN
catered	V
assorted	ADJ
treatment	NN
shop	NN
chic	ADJ
partying	NN
deserts	NNS
seaside	ADJ
flies	NNS
especially	ADV
pot	V
requests	NNS
angry	ADJ
complex	ADJ
received	V
flat	ADJ
hotels	NNS
car	NN
visits	NNS
2012	CD
hostel	NN
chose	V
save	ADJ
air	NN
europe	NN
allocated	V
add	ADJ
check	NN
rotten	V
basically	ADV
dead	ADJ
cheese	ADJ
registration	NN
thanks	NNS
bands	V
satisfied	ADJ
cross	NN
nevertheless	ADV
enjoy	V
anything	NN
fact	NN
roof	ADJ
diner	NN
trained	V
countryside	ADV
arranged	V
quickly	ADV
standard	ADJ
location	NN
confusing	V
con	NN
refrigerator	NN
maximum	ADJ
knew	ADJ
earth	NN
business	NN
cleaned	V
healthy	ADJ
chears	NNS
m	V
goggle	NN
comforts	NNS
condition	NN
plaesantly	ADV
view	V
french	ADJ
ã¡gent	NN
reception	NN
happened	V
ritz	ADJ
choises	NNS
workers	NNS
responsibility	V
likely	ADJ
aren	ADJ
accomodation	NN
dusting	V
lunch	NN
miles	NNS
luggage	V
redeeming	V
lagune	NN
knowledgeable	ADJ
scenic	ADJ
finding	V
surf	NN
grey	NN
extrasthe	ADJ
playing	NN
volvereta	NN
radio	NN
knowledge	NN
swans	V
mall	ADJ
12	CD
hang	NN
smooth	CC
travelodge	NN
transport	ADV
gorgeous	ADJ
deventer	NN
nadia	NN
1300	CD
confortable	ADJ
kindness	NN
hospitable	ADJ
felt	V
urine	ADJ
unclog	ADJ
entrance	NN
shadows	V
option	NN
hosts	NNS
disaster	NN
feature	NN
try	V
120	CD
visitors	NNS
vitosha	ADJ
changes	NNS
wife	NN
barcelona	V
possibility	NN
us	PRP
ibis	V
booked	ADJ
lanka	NN
orders	NNS
charming	V
jammed	V
some	DT
as	IN
400	CD
varieties	NNS
heard	V
confirmation	NN
over	IN
lousy	ADJ
burger	NN
everywhere	ADV
b	V
checking	V
amp	ADJ
kinds	NNS
residential	ADJ
shabby	NN
ijust	NN
christmas	NN
mohamed	V
entertaintments	NNS
pass	ADJ
return	NN
walking	V
cover	ADJ
please	NN
jumeriah	ADJ
blend	NN
summary	ADJ
gaps	NNS
ancient	ADJ
cafe	ADJ
peaceful	ADJ
love	NN
der	NN
immediately	ADV
note	V
although	IN
welcome	ADJ
infrastructure	NN
stained	V
sit	ADJ
spacy	NN
fault	NN
field	NN
ad	NN
fully	ADV
cozy	ADJ
establishments	NNS
escalator	NN
singer	NN
desert	ADJ
toilet	NN
any	DT
through	IN
hear	ADJ
suite	ADJ
something	NN
coming	V
tourists	NNS
funny	V
n	ADJ
trips	NNS
avoided	V
unclear	ADJ
towels	NNS
fresh	V
timely	ADV
forthcoming	ADJ
across	IN
helping	V
village	NN
upper	NN
also	ADV
spend	ADJ
century	NN
delicious	ADJ
efficient	ADJ
smart	NN
had	V
ll	V
job	NN
olso	NN
telling	V
organised	V
give	V
a	DT
personally	ADV
recent	ADJ
elevators	NNS
espresso	V
cereal	NN
attractive	ADJ
rest	NN
level	NN
missing	V
tube	NN
can	MD
cigarette	V
function	ADJ
cottage	NN
making	V
alright	ADJ
variety	NN
taken	V
points	NNS
75	CD
addition	NN
english	ADJ
convenience	NN
elegance	NN
asked	V
sablon	ADJ
palazzo	NN
just	ADV
friendliness	ADJ
tho	ADJ
sofa	NN
connection	NN
relaxatio	NN
george	NN
dame	NN
dark	ADJ
inclysive	ADJ
decorated	V
isolation	NN
centrally	ADV
state	NN
because	IN
together	NN
rock	NN
14	CD
three	CD
missed	V
heated	V
eur	ADV
visiting	V
piece	NN
curtains	NNS
six	CD
this	DT
handicapped	V
where	WRB
dust	ADJ
vehicles	NNS
fat	V
rebuilding	V
magical	ADJ
remark	NN
certainly	ADV
walked	V
tub	ADJ
therethank	NN
possibly	ADV
adjacent	ADJ
first	ADJ
octoberfest	ADJ
wish	ADJ
weekenders	NNS
classiest	V
player	NN
surroundings	NNS
months	NNS
modest	ADJ
inclusive	ADJ
1	CD
south	NN
after	IN
dam	NN
blocks	NNS
tried	V
âs	ADJ
weekend	NN
drinks	NNS
usd	ADJ
ride	ADJ
country	NN
25	CD
distances	NNS
current	ADJ
2	CD
vast	ADJ
furniture	NN
greets	NNS
respective	V
kindly	ADV
lyon	ADJ
swimmingpools	NNS
foyer	V
sky	ADJ
card	NN
checkouts	NNS
largest	ADJ
therefore	ADV
bookingcom	ADJ
reach	NN
she	PRP
streetside	ADV
educated	V
hamam	ADJ
least	ADJ
day	NN
notre	ADV
requested	V
neightborhood	NN
germans	NNS
ever	ADV
wonderfully	ADV
hell	ADJ
offering	V
fridge	NN
liquires	NNS
polish	ADJ
relaxed	V
invite	ADJ
television	NN
marriott	NN
builders	NNS
croissants	V
bubba	NN
services	NNS
worked	V
thessaloniki	ADJ
competent	ADJ
sports	NNS
unique	NN
maid	V
less	ADV
smoking	V
not	ADV
are	V
paying	V
dedicaced	V
casa	NNS
cuisine	V
then	ADV
udaivilas	ADJ
backing	V
common	ADJ
lanxess	NN
30th	CD
should	MD
dinner	V
proximity	NN
going	V
stephanie	ADJ
travellers	NNS
makes	V
still	ADV
exceptional	ADJ
liked	V
thoroughly	ADV
somewhere	ADJ
honeymooners	NNS
pathã©	V
another	DT
never	ADV
handle	V
perfectly	ADV
trafford	ADJ
beautiful	ADJ
words	NNS
servings	NNS
placed	V
afraid	ADJ
anna	NN
go	V
abundant	ADJ
let	NN
coach	NN
quality	NN
forced	V
presented	V
amasing	V
choice	NN
explore	ADV
cook	V
closer	ADV
during	IN
choose	ADJ
ã	NN
childrens	NNS
my	PRP$
swipe	ADJ
behold	ADJ
wc	NN
robbed	V
away	ADV
shower	ADJ
miami	NN
planning	NN
degrees	NNS
weekends	V
manager	NN
warm	ADJ
families	NNS
reliable	ADJ
greek	ADJ
personnel	NNS
at	IN
even	ADV
damaged	V
possible	ADJ
cake	NN
brandy	NN
dance	NN
pictures	NNS
appart	V
restaurat	ADJ
portions	NNS
advance	NN
oberoi	ADJ
insects	NNS
actual	ADJ
overall	ADJ
except	IN
grounds	NNS
railway	V
number	NN
mistake	V
carte	ADJ
copenhagen	NN
vip	NN
getting	V
distance	NN
seemed	V
executive	ADJ
aerea	NNS
who	WP
bugs	V
attending	V
importen	ADJ
value	NN
excusive	ADJ
moquette	NN
facilities	NNS
housekeeping	V
trousers	NNS
crazy	ADJ
smoked	V
stations	NNS
winter	ADV
broken	ADV
furnished	ADJ
stays	NNS
bread	V
pitches	NNS
welcomed	V
hamburger	ADJ
station	NN
tend	V
triump	NN
ignorant	ADJ
forum	NN
market	NN
for	IN
sensational	ADJ
reservation	NN
landscaped	V
builnding	V
coffee	NN
chill	NN
out	RP
massage	NN
concerning	V
insulation	NN
plus	CC
taxi	NN
self	NN
sound	NN
carparking	V
rank	NN
do	V
campsite	V
areas	NNS
difficult	ADJ
40	CD
hundred	ADJ
exelent	NN
these	DT
interest	NN
organization	NN
pleasantly	ADV
westminster	ADV
finish	NN
of	IN
shops	NNS
show	V
checkin	ADJ
smsevery	NN
okay	NN
help	V
serious	ADJ
saff	NN
rates	NNS
trier	V
haque	ADJ
improvement	NN
sun	NN
unlike	IN
plays	NNS
reasonable	ADJ
convenient	NN
clerk	NN
nevskii	NN
surely	ADV
cleaners	NNS
sasha	V
unpleasantness	ADJ
â´	NNP
stone	NN
want	V
have	V
montmartre	V
despite	IN
highlights	NNS
here	ADV
spotlessly	ADV
tiny	ADJ
hurghada	NN
rather	ADV
collapses	V
books	NNS
stress	ADJ
own	ADJ
class	NN
low	ADJ
spakenburg	NN
usual	ADJ
charge	NN
luxuryfood	V
the	DT
hr	NN
experience	NN
super	ADJ
doesen	NN
discounts	NNS
cycling	V
setting	V
flamingo	ADJ
bilbao	NN
realy	NN
decent	ADJ
breakfasts	NNS
polite	V
managed	V
thought	ADJ
future	NN
moneyi	NN
impressed	ADJ
mangers	NNS
hours	NNS
reasons	NNS
13	CD
romantic	ADJ
waiters	NNS
association	V
gladly	ADV
constantly	ADV
ok	ADJ
e	NN
sã¶dermalm	NN
taught	V
steam	ADJ
way	NN
scandic	NN
desired	V
march	ADJ
deira	NN
needwe	ADJ
frequent	ADJ
intrusive	ADJ
true	ADJ
reply	NN
inexpensive	ADJ
renovarted	V
1mile	CD
ate	NN
enjoyable	ADJ
grill	NN
picky	ADJ
period	NN
does	V
siena	V
wi	NN
travelers	NNS
exact	V
comprehensive	ADJ
steak	NN
located	V
scam	ADJ
argue	NN
calm	NN
given	V
based	V
compact	ADJ
dress	NN
byron	NN
fi	V
8	CD
louise	NN
laying	NN
inner	ADJ
went	V
spa	ADJ
take	NN
trying	V
equipment	NN
did	V
elysee	V
weren	NN
encountered	V
run	V
money	NN
positive	ADJ
his	PRP$
walkways	NNS
swimming	V
stylish	ADJ
unexpected	ADJ
hotel	NN
general	ADJ
regular	ADJ
far	ADV
district	NN
though	IN
eight	CD
relaxing	V
must	MD
that	WDT
steakhouse	V
chair	NN
2nd	CD
and	CC
ridiculous	ADJ
dorm	NN
kã¶ln	NN
tended	V
climbs	NNS
rum	V
safe	ADJ
dining	V
breaker	NN
yaer	NN
chaos	NN
highway	NN
square	NN
bars	NNS
hussein	V
finest	ADJ
side	NN
known	V
spiderweb	ADV
strongly	ADV
begrudge	V
calling	V
adequate	ADJ
informed	V
etiquette	NN
animations	NNS
sorted	V
exercise	NN
would	MD
bigger	ADJ
thursday	ADJ
maximizes	NNS
running	V
centre	ADJ
destinations	NNS
beginning	V
hence	NN
set	V
climb	NN
putting	V
below	IN
pintxos	NN
comfy	NN
probably	ADV
aqua	V
unfriendly	ADJ
cooks	NNS
troubles	NNS
egg	V
vodka	ADJ
oriental	ADJ
spending	NN
structure	NN
trams	V
melia	ADJ
speaks	NNS
toiletries	NNS
code	V
minute	NN
disclosed	V
verry	ADJ
road	NN
helpfull	NN
highways	V
terrible	ADJ
mail	NN
covered	V
hand	NN
friendy	ADJ
re	NN
attendance	NN
internet	NN
pipes	NNS
serve	V
from	IN
no	DT
torn	ADJ
expect	V
âm	NNP
design	NN
has	V
reality	NN
per	IN
1st	CD
plenty	NN
good	ADJ
slippers	NNS
powerful	ADJ
needed	V
restful	ADJ
guest	NN
grandaughter	NN
tasteful	ADJ
70s	CD
usually	ADV
speak	V
neighborhoods	NNS
connect	V
periferique	NN
surrounding	V
blonde	NN
sercices	NNS
come	V
screen	ADJ
frills	NNS
among	IN
only	ADV
throw	V
immediate	ADJ
eran	NN
via	IN
paths	NNS
get	V
active	ADJ
cant	NN
ât	NN
best	ADJ
star	NN
husaband	NN
up	RP
nespresso	ADJ
choices	NNS
terrific	V
generous	ADJ
worse	ADJ
wilderness	NN
entire	ADJ
bedding	NN
being	V
excursions	NNS
swiming	V
breathtaking	V
3	CD
continue	NN
back	ADV
present	ADJ
thats	NNS
huge	ADJ
aerobicthey	NN
ve	V
trailer	NN
he	PRP
dirt	V
careful	ADJ
week	NN
relations	NNS
people	NNS
clean	V
hte	ADJ
entertain	NN
walk	NN
shape	NN
inn	NN
named	V
bath	NN
swim	NN
detail	NN
nightclub	ADV
varieous	ADJ
alone	ADV
rer	NN
akward	ADJ
access	NN
costs	NNS
patient	ADJ
described	V
negga	ADV
spoken	V
when	WRB
dogs	NNS
colleagues	NNS
information	NN
complaint	NN
completed	V
profession	NN
tanning	V
offers	NNS
apartments	NNS
quit	V
teenagers	NNS
purpose	V
provide	IN
quick	ADJ
higly	ADV
river	NN
last	ADJ
vacationpickalbatros	ADJ
mamlouk	NN
y	NN
music	NN
smelly	ADV
downtown	ADJ
mini	NN
refund	NN
minimal	ADJ
gilde	NN
strip	NN
corner	NN
seashore	V
flughaven	ADJ
stuff	NN
thomsons	NNS
department	NN
20	CD
welcomewould	ADJ
disappointment	NN
gobelins	NNS
starting	V
guys	NNS
neatly	ADV
pluspoint	V
owners	NNS
cabinets	NNS
said	V
plage	NN
surge	NN
students	NNS
transportation	NN
borring	V
front	ADJ
eg	NN
options	NNS
aside	ADV
maintained	V
boutiques	NNS
opera	IN
consider	ADJ
milk	NN
champs	NNS
why	WRB
hilton	NN
sauna	NN
slendid	ADJ
silent	NN
pillows	V
times	NNS
saw	V
once	ADV
meny	ADJ
recommended	ADJ
nice	ADJ
negative	ADJ
young	ADJ
legs	NNS
forward	ADV
facility	NN
certain	ADJ
pluss	NN
cocktails	NNS
years	NNS
backpackers	NNS
important	ADJ
heart	NN
san	ADJ
place	NN
amsterdam	NN
with	IN
interestingin	NN
tasted	V
book	NN
recomend	NN
feel	NN
wide	ADJ
travelodges	V
suit	NN
pay	NN
exposed	V
paradise	ADV
one	CD
contemporary	ADJ
website	NN
realised	V
koln	NN
travelling	NN
garage	NN
alphons	NNS
9	CD
balcony	NN
happiness	NN
match	NN
floods	NNS
soon	ADV
shoping	V
recently	ADV
busy	ADJ
ingeniously	ADV
â¬	NNP
empty	ADJ
carlton	NN
passport	NN
fairly	ADV
thus	ADV
mixed	ADJ
resort	NN
carpet	NN
neighbourhood	NN
same	ADJ
lack	NN
faded	V
mainly	ADV
visible	ADJ
games	NNS
picturesque	V
word	NN
local	ADJ
men	NNS
chairs	NNS
excecutive	V
snorkeling	V
linen	NN
ones	NNS
underconstruction	NN
wanted	V
midnight	NN
zone	CD
creative	ADJ
needs	NNS
could	MD
pizza	V
meal	ADJ
warmly	ADJ
spaces	NNS
refurnished	V
myself	PRP
pants	NNS
sleep	V
dirtyour	ADJ
excellent	NN
pools	NNS
already	ADV
everyone	NN
ship	ADJ
situation	NN
pyramid	NN
verz	NN
complaints	NNS
wery	V
restaurant	ADJ
wheel	NN
daily	ADJ
tournaments	NNS
inside	IN
summer	NN
perfekt	NN
impressions	NNS
open	ADJ
case	NN
rude	NN
key	ADJ
cottages	NNS
rocko	V
luxuries	NNS
firenze	V
professional	ADJ
nationality	NN
hoped	V
fit	ADJ
brits	NNS
tp	V
comfort	NN
drink	V
reason	NN
center	NN
booking	V
roll	NN
allwe	ADV
five	CD
chosen	NNS
rain	V
getaway	ADV
delightful	ADJ
bikes	NNS
ther	ADV
expected	V
tower	ADJ
âd	NN
considered	V
rules	NNS
read	V
replenished	V
shows	NNS
t	IN
amenities	NNS
leeds	NNS
florence	V
beer	NN
whisky	NN
everything	NN
served	V
juices	NNS
snorkelling	V
worn	ADJ
street	NN
necessary	ADJ
port	NN
dated	V
your	PRP$
lovely	ADJ
holland	NN
age	NN
restored	V
france	NN
appreciate	NN
steep	ADJ
night	NN
practically	ADV
honor	V
15	CD
km	NNS
photos	ADJ
awful	ADJ
floor	NN
shoes	NNS
linens	V
print	ADJ
palace	NN
dream	NN
â	NNP
matter	NN
buiseness	NN
might	MD
spirits	V
anymore	ADV
holidaymy	ADJ
otherwise	NN
activities	NNS
beaches	V
deskstop	ADJ
special	ADJ
exceptionally	ADV
foods	NNS
slow	V
reserved	V
stationthe	ADJ
bass	NN
disco	NN
poland	NN
definetely	ADV
agia	ADJ
villa	NN
ensures	NNS
outlet	V
rat	V
madrid	ADJ
main	ADJ
courteous	ADJ
vineyards	NNS
nicest	ADJ
suggest	NN
discovery	NN
both	DT
prado	V
layout	IN
receptionist	NN
wouln	ADJ
thing	NN
euros	NNS
pub	V
family	NN
glad	NN
24	CD
rated	V
eurostar	ADJ
mexican	ADJ
kids	NNS
handled	V
bathroom	NN
alternation	NN
delicacies	NNS
audience	NN
dubai	V
our	PRP$
kitchen	NN
right	ADJ
functional	ADJ
breaks	NNS
working	V
haven	ADV
immaculately	ADV
surprise	V
accompanied	ADJ
tiling	NN
windows	NNS
nightclubs	V
arrival	ADJ
began	V
mood	ADJ
clubs	NNS
bonus	V
reseption	NN
repeatative	ADJ
gift	NN
duck	NN
chipped	V
extremely	ADV
brilliant	ADJ
namely	ADV
site	NN
see	V
titanic	ADJ
were	V
receptionists	NNS
technology	NN
how	WRB
procedures	NNS
closes	V
eyesi	ADV
cared	ADJ
ervery	NN
members	NNS
if	IN
8th	CD
room	NN
touristic	ADJ
bulgaria	NN
twice	NN
goes	V
russian	ADJ
colors	NNS
throughout	IN
aerobic	ADJ
great	ADJ
odd	ADJ
bedroom	NN
riverside	NN
middle	ADJ
environment	NN
designed	V
feeling	V
breakfast	NN
axaha	IN
cope	NN
secure	NN
which	WDT
cannot	V
management	NN
average	NN
faulty	NN
duty	NN
amazing	NN
is	V
visitor	ADJ
assist	ADJ
bus	NN
economically	ADV
spent	V
live	ADJ
champ	NN
chldren	NNS
london	V
mess	NN
plan	NN
excelent	ADJ
loud	ADJ
flag	NN
continental	ADJ
personal	ADJ
finishes	NNS
thinks	NNS
earned	V
rent	NN
fountain	NN
bland	NN
arrived	V
stares	NNS
anyone	NN
dish	NN
be	V
their	PRP$
travel	ADJ
german	ADJ
bed	NN
requires	V
didn	ADJ
available	ADJ
inedible	ADJ
advantadge	NN
cooking	V
fee	NN
massive	ADJ
warmbarman	NN
2010	CD
â·	NN
eurostars	NNS
lock	ADJ
staff	NN
wine	ADJ
reviews	NNS
connected	V
computers	NNS
stay	V
paris	ADJ
remember	V
connections	NNS
small	ADJ
â	NNP
reccomend	NN
world	NN
shelf	NN
arrivals	NNS
mice	V
eat	NN
nes	NNS
la	V
items	NNS
splendid	ADJ
person	NN
trip	NN
vivaldi	NN
bloody	NN
crowded	V
columbus	NN
trimphe	NN
evening	V
invaded	V
flamenco	ADJ
sharm	NN
c	NN
spoilt	ADJ
buy	NN
hearts	NNS
gone	V
oterwise	ADV
rear	ADJ
monmarte	NN
worst	ADJ
orly	ADV
helped	V
smokers	NNS
staying	V
large	ADJ
weekday	NN
before	IN
convention	NN
buffet	NN
provided	V
features	NNS
anybody	NN
doing	V
travelled	V
disappointing	ADJ
employees	NNS
renovation	NN
casino	NN
everyday	ADJ
amount	NN
surprising	ADJ
minuscule	NN
wifi	NN
desk	NN
ration	NN
cause	NN
loved	V
children	NNS
town	NN
â±	NN
under	IN
nl	ADJ
d	NN
simplistic	ADJ
baku	NN
messe	NN
kassandria	NN
waiter	NN
private	ADJ
stains	NNS
interesting	V
fist	NN
until	IN
prepare	ADJ
explain	ADJ
loveliest	ADJ
renewed	V
cool	ADJ
spacious	ADJ
thank	NN
morning	NN
royal	NN
including	V
royalty	NN
businesstrips	NNS
dec	V
everybody	NN
rungis	NN
paied	V
ground	NN
stolen	V
returning	V
horrible	ADJ
or	CC
quite	PDT
an	DT
recommendations	NNS
definitively	ADV
50	CD
outdated	V
hotelthe	NN
menu	NN
stunning	V
homeless	ADJ
think	V
organized	V
dat	NN
poor	ADJ
pretty	ADJ
courses	NNS
each	DT
impression	NN
di	NN
narrow	NN
scrambled	V
mins	NNS
supported	ADJ
central	ADJ
cracked	V
signal	ADJ
restaraunts	NNS
conditioning	V
enterainment	NN
upgrade	ADJ
hermitage	NN
priced	V
acoustic	ADJ
trash	NN
smelled	V
seine	ADJ
dreamy	ADJ
favourite	ADV
marvellous	ADJ
having	V
international	ADJ
commonly	ADV
sufficient	ADJ
bathrooms	NNS
purposed	V
ness	ADJ
looking	V
basic	ADJ
louvre	NN
adjusted	V
suprised	ADJ
noisy	ADJ
fun	NN
next	ADJ
minutes	NNS
table	ADJ
ago	ADV
since	IN
separated	V
luxury	NN
building	V
nov	ADJ
major	ADJ
diversity	NN
character	NN
quicker	NN
know	V
s	V
mr	ADJ
hof	NN
easy	ADJ
hole	ADJ
amstel	NN
attractions	NNS
long	ADV
bother	ADV
frankfurt	ADJ
airport	NN
problems	NNS
better	ADV
flavouring	V
them	PRP
betting	V
looks	NNS
ihad	V
stop	ADJ
humid	NN
elina	ADV
well	ADV
hade	V
washbasin	NN
miro	NN
du	NN
directions	NNS
steigenberger	V
highly	ADV
concept	ADJ
whole	ADJ
numerous	ADJ
golf	NN
holidys	V
pre	ADJ
sunbeds	NNS
advertised	V
meat	ADJ
meetings	NNS
camp	V
girls	NNS
inspection	NN
damage	NN
using	V
overpriced	ADJ
meet	NN
unless	IN
nn	ADJ
weekly	ADJ
meters	NNS
resorts	V
hopping	V
wellness	NN
specially	ADV
made	V
repair	NN
position	NN
variuos	FW
woerden	NN
compared	V
disgusting	V
bright	ADJ
park	NN
tide	NN
animaters	NNS
underneath	V
york	NN
service	NN
without	IN
found	ADJ
places	NNS
kept	V
redecorated	ADJ
claustrophobic	ADJ
ideal	NN
azerbaijan	IN
seeing	V
spot	NN
animators	NNS
talk	V
instead	ADV
martha	ADV
kind	NN
perfume	NN
gave	V
while	IN
idem	NN
thoroughfare	NN
sunbed	V
asian	ADJ
pension	NN
nearly	ADV
tuscany	ADV
decided	V
time	NN
2011	CD
interested	ADJ
insisted	V
pool	ADJ
floors	NNS
crazily	ADV
unhappy	ADJ
yard	ADV
safisfied	V
like	IN
anywhere	ADV
luxurous	ADJ
affordable	ADJ
channels	NNS
included	V
climbing	V
find	NN
