singles	subaylıq
lanxess	lanksess
nice	qəşəng
them	onlara
seashore	dəniz sahili
cake	tort
accompanied	müşayiət olunan
respects	hörmət
calimera	kalimera
interest	maraq
300	300
ours	özümüzünkü
perfectly	mükəmməl
add	əlavə etmək
immidiately	dərhal
greek	yunan
oliver	tayfa
say	ərz etmək
needed	lazımlı
known	məlum
about	haqqında
reserved	bronlanmış
dancers	rəqqasələr
unpleasantness	xoşhallıq
mistakes	səhv
heating	istilik
word	ərz
french	Fransız dili
faded	solğun
verz	ayırma
made	əlli
colors	rəng
lift	qaldırmaq
travelled	gəzinti
warmly	qızğıncasına
detail	detal
surprisingly	təəccüblü
steam	buxarlamaq
extended	uzadılmış
player	oyunçu
booked	bronlanmış
climation	iqlim
talk	söhbət
trees	ağac
kindness	xeyirxahlıq
months	aylıq
might	qüdrət
weekends	həftə sonları
did	ehtiva edən
heater	qızdırıcı
remind	xatırlatmaq
gaps	boşluqlar
info	məlumat
opera	opera
repair	təmir etmək
ve	və
genuine	orijinal
cycling	velosiped sürmə
mice	siçan
expense	xərc
asian	asiyalı
were	var idi
vacation	tətil
1300	1300
dance	rəqs etmək
times	vaxt
length	uzunluq
resorts	kort
en	içində
views	mənzərə
end	bitirmək
superfriendly	möhtəşəm
station	yer
ever	hərdən
food	qida
gave	verdi
welcomewould	Woeldwould
air	hava
doesen	çirkin
mega	mega
fingerprints	barmaq izləri
interesting	matelik
liquires	mayeləşdirmək
most	ən çox
trained	öyrədilmiş
welcoming	xoşhalat edən
casa	Ev
barcelona	barelona
storage	saxlama
boat	qayıq
enough	yetər
egypts	Misir
definetely	qəti
able	qadir
collapses	çökdürmək
fi	olmaq
strongly	güclü
train	qatarlanmaq
suprised	nayiş
russians	rus
pantaneto	Pantaneto
splendid	şöhrətli
nearby	yaxınlıqdakı
unique	unikal
again	yenidən
tram	tramvay
enjoy	həzz almaq
association	dərnək
la	bu
canal	kanal
luxury	dəbdəbəli
construction	Tikinti
ther	lap
still	lovğalıq
instead	əvəzinə
continue	davam etmək
choices	seçim
disclose	ifşa etmək
satisfied	qanıq
halles	ştamp
ridiculous	gülünc
basically	əsasən
accommodating	yerlik
swiming	üzgüçülük
amp;	amp;
happy	xoşnud
brits	brits
pluss	üstəgəlmə
famous	məşhur
bilbao	bilbao
simple	sadə
wouln	vouln
hade	var idi.
steigenburger	Steigenberger
short	qısmamış
oasis	oasis
became	halqalamaq
surge	artım
cracked	çatlaq
usual	adi
river	çayın
sauna	sauna
base	baza
used	istifadə olunan
insects	böcək
pot	qazan
black	qara
reach	çatmaq
airport	hava limanı
requires	tələb olunan
brilliant	şəfəqli
daily	gündəlik
recomended	tövsiyə olunan
handle	sönükləmək
refrigerator	soyuducu
cereal	taxıl
serve	xidmət etmək
delighed	çox sevindi
arrival	gəliş
vitosha	vitosha
nord	Şimal
book	kitab
attending	iştirak etmək
match	uyğunlaşmaq
junior	kiçikyaşlı
chairs	stullar
recommended	tövsiyə
map	xəritə
stained	lövhəli
break	fasilə
condition	şərt
120	120
architecture	memarlıq
summer	yay
disadvantage	əlverişsiz mövqe
aqua	aqua
accustomed	vərdiş
exceptional	müstəsna
visiting	ziyarəti
nationality	milliyyət
wait	Gözləmək
remember	yadda saxlamaq
case	xasiyyət
ate	yedimləmək
attention	diqqət
credit	kredit
aren	arıq
conected	əlaqədar
nn	nn
closes	yekun
ansd	umuz
flight	reyska
10	Əqrəb
dam	bənd
house	ev
guys	uşaqlar
delicacies	zərifliklər
backpackers	sırt çantaları
comfortable	rahat
vineyards	üzümçülər
ã¡gent	Aqalətli
important	əhəmiyyətli
any	hər hansı
streets	küçüklər
romantic	romantik
basic	əsas
bulgaria	Bolqarıstan
incredibly	inanılmaz dərəcədə
ms	Xanım
transition	keçid
review	baxış-icmal
included	bir kəsin daxilində
sharm	şarj
or	və ya
as	kimi
rungis	rungis
expensive	bahalı
businesstrips	işgüzar
improved	təkmilləşdirilmiş
service	xidmət
real	real
wheel	təkər
sorted	arıtlanmış
rimini	rimini
s	s
ijust	Mən indicə
wife	arvad
odd	tək
amstel	amstel
bed	yataq
funny	məzəli
sã¶dermalm	sã¶dermalm balası
supburb	sönük
organized	mütəşəkkil
advise	tövsiyə etmək
lobby	lobbi
normally	normalcasına
everywhere	hər yerdə
aquagym	Aquagym
look	baxmaq
brussels	brüssel
happily	xoşbəxtliklə
renovarted	Renovorted.
insulation	izolyasiya
signal	siqnal
landscaped	landşaft
perfect	mükəmməlləşdirmək
smelly	yaman
regular	müntəzəm
excusive	titrəyən
gift	hədiyyə
welsh	uels
due	görə
brought	gətirdi
rated	qiymətli
safisfied	qanıq
always	həmişə
decorated	bəzədilmiş
under	alt
fitness	yararlılıq
help	kömək etmək
stuck	ayıblı
completely	tam
weekend	həftə sonu
bedding	yataq
paid	pullu
facility	Təsis
5	Əqrəb
enmenons	Emmenonlar
willing	istəkli
save	yadda saxla
yourself	özünüz
repeat	təkrarlamaq
steep	diri
mins	dəli
maintained	saxlanılan
sercices	xidmətlər
can	bacarmaq
unclear	aydın olmayan
wasnt	watnt
afew	bir az
subway	metro
extreme	ekstremal
bridge	körpü
vas	Sən
blend	qıvrılmaq
grey	Boz
bikes	velosiped
get	almaq
cuddle	qudurmaq
his	onun
jacuzzi	qakuzmaq
sell	satmaq
relaxing	rahatlaşan
hi	hi
troubles	çətinliklər
rank	dərəcə
improvement	təkmilləşdirmək
rooms	otaqlar
described	təsvir edilən
redeeming	satqı
poor	yoxsul
pub	pub
wilderness	səhra
originally	əvvəlcə
traffic	trafik
economically	qənaətli
partying	partiyalar
gold	qızıl
she	o
another	başqa
guests	qonaq
code	kodlaşdırmaq
rambla	rambla
royalty	royalti
computers	kompüterlər
3rds	3-cü
comparing	müqayisə
friendly	mehriban
chair	kafedra
trash	zibil
setting	tənzimləmə
knew	bilən
features	xüsusiyyətləri
faulty	nöqsanlı
words	söz
actually	əslində
blocks	bloklar
arc	qövs
supermarket	supermarket
les	bu
shous	ayaqqabı
maker	yaradan
including	o cümlədən
young	gənc
washbasin	çuval
provide	təmin etmək
gardens	bağbanlar
cloth	bez
similar	oxşar
pirates	quldurluq
stares	ulduz
darling	sevgili
online	onlayn
package	paket
yoghurt	qatıq
25	Əqrəb
issue	problem
chill	soyumaq
means	varlıq
responsibility	məsuliyyət
to	üçün
siena	siena
beds	çarpayı
same	eyni
definitely	qəti
champs	çempion
adequate	adekvat
road	Yol
admire	heyran etmək
pass	keçmək
pitches	çürükçülər
other	digər
bass	bas
juices	şirniyyat
;	Açıq
supported	dəstəkli
courteous	nəzakətli
general	general
allwe	alabalaca
spacy	spacy
cozy	rahat
we	Biz
weekly	həftəlik
round	yumru
self	öz-özünə
snorkelling	snorkelling
thomsons	thomsonsons
pity	təəssüflənmə
live	yaşamaq
speed	sürətlə
mainly	əsasən
course	kurs
haven	sığallaşmaq
400	400
2	2-ci
piece	hissə
8	Əqrəb
e	e
roll	rulonlamaq
friends	dostlar
death	ölüm
breaker	qırıcı
structure	quruluş
waiters	saman
scandic	skandik
hour	sair
tasted	dad-dadan
courses	kurs
table	masa
tp	tp
hussein	hüsətli
local	yerli
toilet	tualet
ok	tamam
long	uzun
huge	böyük
lovely	sevimli
overal	hər yerdə
jumeriah	yeptik
consider	nəzərə almaq
gare	yer
alive	canlı
countryside	kənd
pension	pensiya
fee	haqq
between	arasında
above	yuxarıda
cheap	ucuz
costlier	bahalı
nicest	əncam
clubs	klublar
environment	mühit
dreamy	xəyali
poland	polşa
antic	keçmiş
2012	2012
finishes	bitirdikləri
downside	mənfi cəhət
hip	hip
website	veb sayt
grounds	zəmin
damaged	zədələnmiş
regard	nəzərə almaq
mixed	qarışıq
reservations	rezervasyon
furniture	mebel
diversity	müxtəliflik
apart	ayrı
swimmingpool	üzgüçülük hovuzu
frienly	Mehriban
handled	əlli
correspond	uyğunlaşmaq
wery	sızmaq
comprehensive	hərtərəfli
cope	öhdəsindən gəlmək
20	20-ci il
big	yekə
dish	qaba
tele	tele
telling	dedik
groups	qrup
spoken	danışıq
smell	iyləmək
after	ardınca
situation	vəziyyət
versa	əksinə
copenhagen	kopenhagen
expect	gözləmək
noice	novice
pillows	yastıq
dust	tozlamaq
frankfurtter	Frankfurter.
amount	miqdar
realy	dəcdə
foor	yumru
refurnished	qalıq
conveniently	rahatca
happiness	xoşbəxtlik
udaivilas	udaivilas
kallithea	kalitet
buffet	bufet
moved	köçürmək
palace	Saray
entire	bütöv
something	bir şey
future	gələcək
video	videonuz
childrens	uşaqlıq
matter	məsələ
although	baxmayaraq ki
kindly	mehribanlıqla
centrally	mərkəzində
swipe	sürmək
staffs	kadrlar
disabled	əlil
opportunitys	imkan
layout	sxem
pond	hovuz
of	biri
th	th
good	yaxşı
before	əvvəlki
smelt	yırğalama
amsterdam	amsterdam
world	aləm
grill	qril
adults	böyüklər
tanning	aşılayıcı
period	dövr
pluspoint	plusmoint.
empty	boş
confortable	rahat
speaking	danışan
smoking	siqnalı
rate	qiymətləndirmək
highly	yüksək
fitnes	yararlılıq
fabulous	inanılmaz
4	4-ə
ad	elan
four	dördlük
deventer	Deventer
prepare	hazırlaşmaq
golf	golf
better	xeyli
well	yaxşı
available	mövcud
english	ingilisləşdirmək
amazing	heyranedici
deserts	çöl
flamingo	flaminqo
der	bu
situated	məskən
1	1
fantastic	fantastik
gets	alır
champ	çempion etmək
ingeniously	ixtisasla
stations	stansiyalar
fountain	çəpər
yard	həyət
cooks	aşpaz
state	dövlət
manager	müdir
ancient	qədim
character	xasiyyət
market	bazar
lost	məğlubedici
renovation	abadlıq
went	getdi
feel	hiss etmək
load	yükləmək
addition	əlavə
day	gün
wooden	taxta
point	fəhm
decent	layiqli
restaurants	restoran
brocken	broken
pretty	yaraşıqlı
carte	kart
complained	şik-basardı
line	cərgə
moneyi	pul
keys	düymə
now	İndi
minute	bir dəqiqə
etc	və s
y	Y
extremly	ifrat
linens	kətan
connections	hərf
narrow	daraltmaq
eran	var idi
returning	qayıtma
abundant	bol
painting	rəsm
children	uşaqlıq
uncomfortable	narahat
up	yuxarı
playing	oynayan
stars	ulduz
prepared	hazırkı
eg	məsələn
frankfurt	frankfurt
ritz	ritz
non	qeyri
competent	səriştəli
amasing	icma
efficient	sərfəli
steak	biftek
lounge	lounge
jammed	sıxılmış
holidys	tətil
set	quraşdırmaq
elderly	yaşlı
channel	kanal
idem	eyni
areas	zahir
nov	nov
surroundings	ətraf
cigarrum	cigarrum
unhappy	bədbəxt
call	zəng etmək
equipped	təchiz olunmuşdur
believe	inanmaq
km	km
easy	asan
underconstruction	təslim edilməsi
drain	qurutmaq
touristic	turist
chears	Turciks
needwe	nailwe
meny	menyu
magical	sehrli
du	dən
unclog	açmaq
brandy	brendi
overall	Ümumilikdə
starting	başlayan
accomodation	iclas
destination	təyinat
calm	rahatlamaq
dining	yemək
spacious	geniş
tv	televizor
attitude	münasiblik
floors	mərtəbə
acceptable	məqbul
dvd	dvd
assoiated	əlaqəli
certain	müəyyən
inedible	başaz
excursions	Ekskursiyalar
highways	magistral
experienced	təcrübəli
worth	dəyər
cottage	kottec
travelling	səyahət etmək
âd	â € ™
bonus	bonus
2nd	2-ci
martha	martha
robe	cübbə
not	yox
taste	dadmaq
for	üçün
mould	kif
beaches	çimərlik
family	ailəsi
stays	qalır
office	iş
disclosed	açıq-saçıq
checkouts	yoxlama
compact	yığcam
hof	hof
50	Əqrəb
however	lakin
begrudge	qızdırmaq
anything	bir şey
presented	Təqdim edildi
peaceful	dinc
terrace	terras
superb	əlverişli
convenient	əlverişli
maid	mail
plage	Çimərlik
super	super
arena	arena
swimming	üzgüçülük
30	Əqrəb
visits	səfər
meat	ət
realised	real
deal	sövdələşmək
placed	yerdəkli
wonderfully	heyranlıqla
with	ilə
anywhere	hər yerdə
toast	tost
current	cərəyan
bar	çubuq
finest	ən yaxşı
date	Tarix
olive	zeytun
queue	növbə
department	şöbə
jaccuzzi	jakuzzi
nite	nite
invite	dəvət etmək
polite	nəzakətli
picky	alqış
stag	zırı
palazzo	palazzo
dame	ayırıcı
near	yaxın
oberoi	oberoi
octoberfest	Oktoberfest
con	ilə
all	hamar
bus	avtobus
earth	yer
curtains	pərdər
late	gec
throw	atmaq
dj	dj
worst	ən pis
european	avropalı
whisky	viski
downtown	şəhərin mərkəzində
procedures	prosedur
weekday	işgün
checked	yoxlanılan
montmartre	montmartrre
few	azyaşlı
saw	mişar etmək
buiseness	Biznes
30th	30-cü
lack	əskiklik
bugs	buğda
700	700
wide	geniş
club	klub
present	indiki
animators	animator
altstadt	altstadt
residents	sakinlər
less	az
going	gəmi
t	t
through	vasitəsilə
beginning	Başlanğıc
menu	menyu
paper	kağızlamaq
professional	peşəkar
angry	hirsli
espaccely	təlqəbanə
timing	vaxtlama
busy	məşğul
glad	xoşnud
polish	cilalamaq
stress	vurğu
trips	gəzintisi
cost	dəyəri
buildings	binalar
destroyed	yıxılmış
luxuryfood	luxuryfood
educated	təhsilli
double	qoşalaşmaq
premises	bina
seems	görünür
climbing	dırmaşan
hot	haşiyə
style	stil
bathrooms	vanna otağı
level	səviyyə
generous	səxavətli
encountered	rast gəlmək
feels	hiss etmək
18th	18-ci
speak	danışmaq
russian	rus
coming	gəlir
liked	bəyənilən
took	alıb aldı
tourist	turist
casino	kazino
rock	qaya
desert	səhra
know	bilmək
humid	rütubətli
corner	künc
managed	idarə olunan
people	Xalq
luxor	lüks
expected	gözlənilən
want	könlü olmaq
confusing	çaşdırıcı
thick	qalın
attitudes	rəftar
inclusive	əhatəli
exercise	məşq etmək
gran	əla
confirmation	təsdiqləmə
ll	ll
work	işləmək
meters	metr
fit	uymaq
vacationpickalbatros	vakationpickalbatros
personally	şəxsən
receptionists	reseptorlar
disappointing	məyus
german	almanca
milk	süd
conditions	şərait
deter	ləcləşmək
notre	bizim
nightclub	gecə klubu
borring	Corring.
began	başlanğıc
amination	ölüvay
staircase	pilləkan
excelent	excelent
torn	cırıq
respective	əlaqədar
was	idi
belongings	əşyalar
your	sənin
restourant	restoran
turkey	hinduşka
hostess	sahibə
chef	aşbaz
business	Biznes
utrecht	utecht
bliss	zövq
visitors	ziyarətçi
siro	siro
spaciousthe	əndazəli
n	n
timely	vaxtında
saff	qatar
you	Sən
â´	əqrəba
titanic	titanik
someone	kimisə
swim	üzmək
specially	xüsusi olaraq
special	xüsusi
screen	ekran
eurostars	eurostars
24	24
fully	tam
interestingin	Maraqlı
unforgettable	unudulmaz
such	bu cür
sun	günəş
who	üst
july	iyul
upper	yuxarı
evening	axşam
area	sahə
little	balaca
pyramid	piramida
holes	deşik
bookingcom	broningcom
warm	istilənmək
usd	ABŞ dolları
streetside	küçü
cleanliness	təmizlik
literally	eynən
variety	müxtəliflik
c	c
milano	milo
despite	rəğmən
75	75
villa	villa
picturesque	mənzərəli
leaving	tərk etmək
off	sönük
healthy	sağlam
own	öz
surprised	təəccüblü
modern	müasir
loveliest	ən sevən
elegance	zəriflik
receptionist	resepşn
costs	xərclər
water	suvarmaq
tallinn	tallinn
homeless	evsiz
place	yer
axaha	dəb
seeing	görkəmli
extrasthe	Ekstrast
deprived	məhrum
but	Amma
back	geri
trafford	tachord
serious	ciddi
sheets	cərgə
forthcoming	qarşıdakı
dat	Hansı
may	bilər
dirty	çirkləndirmək
espresso	espresso
typical	tipik
14	Əqrəb
establishments	müəssisələr
executive	icraedici
april	aprel
soon	yaxında
zone	zona
mistake	səhv
leeds	leeds
kids	uşaqlar
sasha	saşa
idea	fikir
welcomed	qarşılandı
plaesantly	qaba-qaba
discounts	endirim
probably	yəqin ki
i	mən
shower	duş
arranged	düzülü
comforts	təsəlli
foyer	foye
proffesional	peşəkar
suprise	sıçrayış
twin	əkiz
pm	axşam
extra	əlavə
many	çox
horrible	dəhşətli
appreciate	qiymətləndirmək
miss	darıxmaq
next	sonrakı
trams	tramvay
cheese	Pendir
incredible	inanılmaz
foods	qida
change	dəyişmək
type	tip
dated	tarixli
sky	səma
dirt	kirə
9	Əqrəb
could	ala-seyrək
take	götürmək
and	və
bands	lentlər
express	ekspress
best	ən yaxşı
nadia	nadia
builders	inşaatçılar
bland	viran
paths	yol
clerk	kargüzar
noise	səs-küy
wg	içində
restored	bərpaolunan
azerbaijan	Azərbaycan
secure	təhlükəsiz
use	istifadə etmək
absolutely	tam
delicious	ləzzətli
it	o
be	olmaq
commonly	ümumiyyətlə
surf	sörf etmək
hang	asmaq
low	alçaq
nothing	heç nə
euros	avros
traveling	səyahət etmək
attendance	iştirakçılıq
machine	dəzgah
buy	almaq
âm	â € ™
bathtub	küvet
soap	sabun
og	və
rubber	rezin
carlton	carlton
dinner	nahar
silent	səssiz
massage	masaj etmək
shoping	karxana
impression	təəssürat
gobelins	qobelins
husaband	Havenand.
early	vaxtlı
italien	İtaliya
pubs	meyxanalar
pools	hovuzlar
too	həmçinin
sound	səs
workers	işçi
relaxatio	rahatlama
profession	peşə
treatment	müalicə
forced	məcburi
tide	gelgit
hr	vaqonetləmək
old	köhnə
travel	səyahət etmək
are	var
relations	əlaqələr
hand	əl
finding	tapıntı
below	aşağıda
knowledge	bilik
into	içinə
dishes	qablar
meetings	iclaslar
new	yeni
pleasant	xoş
biggest	ən böyüyən
lake	göllük
inner	daxili
cottages	kottecer
teenagers	yeniyetmə
isolation	izolə
view	baxış
square	kvadrat
february	fevral
marvellous	ecazkar
received	alıb almış
certainly	əlbəttə
that	bu
explore	araşdırmaq
dorm	yırtıq
management	rəhbərlik
relaxed	rahat
reviews	rəylər
seats	oturacaq
wine	şərab
george	george
priced	fiyatlı
convenience	rahatlıq
working	iş
arrivals	gəlib-gəl
advance	avanslaşdırmaq
outside	kənarda
york	yez
flag	bayraq
only	yalnız
vips	vips
hard	çətin
negative	mənfi
robbed	qarətlənmiş
worse	betər
hotelthe	otel
walking	gəzinti
check	yoxlamaq
looking	baxışsız
hosts	hostlar
my	mənimsəmə
bright	parlaq
varieous	ən çox
various	müxtəlif
departure	yoluxma
leaking	sızma
experience	təcrübə
choose	seçmək
way	yol
card	kart
canine	canine
tasty	dadlı-duzlu
pleaseure	zovq
exceeded	aşdı
toiletries	tualet əşyaları
passed	keçirilmiş
stolen	oğurlamaq
transport	daşınma
haque	haqu
vehicles	nəqliyyat vasitələri
foot	ayaq
mamlouk	mamlouk
park	park
distance	məsafə
else	allahsız
christmas	məlahət
akward	yöndəmsiz.
impressions	təəssüratlar
kuku	mıx
bars	çubuqlar
cusines	mətbəxlər
hoped	ümidlə
amp	amp
november	noyabr
crowded	izdihamlı
twist	bükmək
acoustic	akustik
7	7-yə
luggage	baqaj
pleases	xoşniyyət
active	fəal
members	üzvlər
return	qayıtmaq
organization	təşkilat
without	onsuz
on	yan
recommend	tövsiyə etmək
highlights	xülasə
meals	yemək
entrance	giriş
sunbeds	quduzluq
lanka	lanka
thoroughly	hərtərəfli
spa	spa
entertain	əyləndirmək
left	sol
replinished	doldurulmuş
night	gecə
adjacent	bitişik
elegant	zərif
boring	qazıma
rat	siçovul
wifi	wifi
vast	geniş
when	nə vaxt
weren	cığır
trouble	narahatlıq etmək
actual	faktiki
diffrent	fərqli
asked	istənilən
dirtyour	kirli
travelers	səyahət edənlər
functional	funksional
ât	T olmayın
revisiting	yenidən baxmaq
duck	ördək
lyon	lyon
directly	birbaşa birbaşa
window	pəncərə
orly	beləliklə
deskstop	masaüstü
goes	yoğun
option	seçim
tried	cəhd
40	40
276	276
moquette	xalça
normal	normal
claiming	iddia edən
spreads	yayılmış
â	â €
products	məhsullar
myself	özüm
straight	düz
from	dən
rain	yağış yağdırmaq
ð¢his	ð onun
support	dəstək vermək
massive	kütləvi
sports	idman
range	menzil
behold	görmək
stunning	təəccüblü
maximum	maksimal
loved	sevdi
life	həyat
lot	çox
needs	ehtiyaclar
walkways	piyada yolları
recomend	tövsiyə etmək
tha	Mən edəcəyəm
monmarte	montmartrre
reef	ref
job	iş
elevators	liftlər
reasonable	ağlabatan
feast	Ziyafət
checking	yoxlama
seemed	görünən
they	onlar
stone	daş
fine	cərəyan
indeed	doğrudan da
maybe	ola bilər
backing	dəstək
favourite	Sevimli
lamps	çıraqlar
please	xahiş edirəm
request	istək
louvre	louvre
march	mart
boys	oğlanlar
students	tələbələr
customer	müştəri
taxi	taksi
allowing	icazə vermək
15	15
therefore	buna görə
stains	ləkə
said	dedi-qodu
holland	qətran
ask	istəmək
exposed	məruz
lunch	nahar
avoid	qaçınmaq
cleanest	təmiz
should	lazım olsa
simply	sadəcə
ration	rasion
girls	qız
compared	müqayisəedici
prefect	prefekturasiya
thrown	atılmaq
argue	dəbərmək
gym	idman zalı
friendy	rövnəqli
riverside	çay kənarı
smsevery	şaxtababalıq
thank	şükür etmək
offer	təklif etmək
mum	mum
conditioning	kondisioner
village	kənd
rebuilding	yenidən qurma
middle	orta
heard	eşitdim
note	Qeyd
smoked	hisə verilmiş
enterainment	zahir
burger	burger
fish	balığı
boy	oğlan
columbus	columbus
explain	izah etmək
amenities	şəraiti
complaint	şikayət
quiet	sakitləşdirmək
smart	ağıllı
already	onsuz da
won	qalib
dead	ölü
choises	seçim
pitch	qatmaq
shabby	köhnədən
plus	üstəgəlmə
feb	fevral
walk	gəzmək
travelodge	səyahətodjası
hotelmanager	otelçuager
getaway	qaçıb getmək
claustrophobic	klaustrofobik
great	əla
immediate	dərhal
radio	radio
throughout	boyunca
whole	bütöv
sastisfied	qanıq
surprise	sürpriz
singer	müğənni
bad	pis
while	isə
hermitage	alverçilik
side	yan
worn	cıdır
tasteswe	tasteswe
terrific	dəhşətli
hurghada	hurghada
competences	səlahiyyətlər
enjoyable	xoş
yaer	Üst
first	birinci
lots	çoxlu
resort	kurort
favorite	Sevimli
flughaven	Hava limanı
dubai	Dubay
observations	müşahidə
elina	elinina
linked	əlaqələndirilmiş
disappointed	məyus
central	mərkəzi
located	olan
builnding	bina
district	rayon
frills	frills
men	kişilər
apartments	mənzillər
unacceptable	qəbuledilməz
planning	planlaşdırma
windows	pəncərə
10m2	10m2
step	addım atmaq
scrambled	titrək
replenished	doldurulmuş
hotels	otellər
chaos	xaos
spakenburg	Spakenburg
changes	dəyişiklik
possible	mümkün
safety	təhlükəsiz
creative	yaradıcı
scenic	mənzərə
orders	sərəncam
organised	mütəşəkkil
san	sancar
goggle	bülmək
worries	narahatlıq
six	altıca
keep	saxlamaq
wireless	simsiz
tastes	dad-ləzzət
considering	nəzərə alaraq
tiling	kirəmit
pipes	boru kəmərləri
towels	dəsmal
heaven	Cənnət
offered	təklif olunan
insisted	israr
lousy	lousy
playground	oyun meydançası
lagune	lagoon
rum	rum
helpfulathe	kömək
named	adlı
us	bizə
provided	verilmiş
fault	arıza
hall	züle
each	hər
vivaldi	vivaldi
per	başına
worked	işlənmiş
spiderweb	hörümçək toru
hopping	hoppanma
have	varlandırmaq
would	əzmək
domicile	yaşamalıq
wellness	sağlamlıq
thought	fikirləşmək
70s	70 x
flights	uçuşlar
summary	xülasə
plays	pyes
stylish	şık
location	yer
contemporary	çağdaş
tip	ucu
cleaned	təmizlənmiş
system	sistem
being	varlıq
girl	qız
housekeeping	ev təsərrüfatı
dutch	holland
bring	gətirmək
steps	addım
dream	xəyal etmək
atmosphere	atmosfer
elevator	lift
friend	dost
rude	kobud
their	özləri
thats	bu
roof	dökmə
name	ad
trailer	trailer
varieties	saxtakarlıq
rail	rels
largest	ən böyüyü
disco	diskoteka etmək
quality	keyfiyyət
though	hərçənd
thanks	şükür etmək
mgmt	mgmt
somewhat	bir qədər
reasons	Səbəblər
pre	əvvəlcədən
shape	formalaşdırmaq
shop	dükan
tournaments	turnirlər
bathrobes	xalatlıq
montjuic	montjuik
recommendation	tövsiyə
perfume	ətir
beer	pivə
nl	nl
proximity	yaxınlıq
issues	məsəl
cigarette	siqaret
equipment	avadanlıq
also	həmçinin
beautiful	gözəl
tornese	cırıq
marinachania	marina
if	kef
missed	qaçırılmış
trip	gəzinti
bubba	bubba
some	bir qədər
three	üçqat
open	açıq-saçıq
excellent	əla
considered	hesab olunan
mini	mini
koln	koln
paris	isuş
rates	qiymət
tiny	tiny
site	Sayt
egypt	Misir
noisy	səs-küylü
1mile	1 mil
sensational	sensasiyalı
love	sevmək
helpful	faydalı
inexpensive	ucuz
redecorated	yenidən qurulmuşdur
mangers	manger
driving	sürücülük
sofa	divan
cross	xaç
shelf	rəf
persons	zühur
design	dizayn
our	bizim
suggest	təklif
sunbed	günəş saldı
eur	Avro
built	tikilmiş
3	3-cü
holidaymy	vətər
came	qalıcı
minutes	dəqiqəlik
minimal	minimal
ã	ã-
surprising	təəccüblü
blonde	sarışın
couples	cütlüklər
example	misal
together	birlikdə
information	məlumat
anyway	hər halda
continental	kontinental
slippers	qırıcı
decorative	dekorativ
restaurant	restoran
anymore	artıq
mother	ana
overpriced	həddən artıq çoxdur
far	uzaq
reliable	etibarlı
international	beynəlmiləl
extremely	son dərəcə
servings	portret
one	bir
camp	düşərgə
price	qiymət
fast	sürətlə
assorted	çeşidli
served	xidmət
cocktails	kokteyllər
cuisine	Mətbəx
weather	hava
fridge	soyuducu
outlet	çıxış
wasn	isbatlı
therethank	teretkank
everything	hər şey
paying	ödəyən
restaurat	bərpaolunan
theres	taxıl
hamburger	hamburger
infrastructure	infrastruktur
iron	dəmir
shame	rüsvayçılıq
aldo	aldo
daytime	gündüz
thursday	Cümə axşamı
thoroughfare	avtoritet
attractive	cəlbedici
anna	anna
last	axırıncı
fairly	kifayət qədər
1st	1-ci
kã¶ln	kÃ¼ln
luxurious	dəbdəbəli
looked	baxış
in	içində
varied	müxtəlif
door	qapı
quit	çıxmaq
noticeable	nəzərdəətli
run	qaçmaq
checkin	kontrol
pintxos	pintxos
deira	deira
frequent	tez-tez
locate	yerləşdirmək
phone	telefon
immaculately	qüsursuz
chic	qəşəng
territory	ərazi
spoilt	korlanmış
parts	qoz
concept	konsepsiya
large	böyük
especially	xüsusilə
disappointment	məyusluq
noticed	görkəmli
doing	etmək
missing	itkin
fun	ayağıyüngül
liable	cavabdeh
butt	butt
oversee	nəzarət etmək
finished	bitmiş
bother	zəhlətökmək
freezing	donma
access	Giriş
problem	problem
recent	son
wi	Və
mountains	dağlar
morning	səhər
shuttle	servis
floaties	üzgünlük
home	ev
plan	plan
marriott	ərrəsi
bread	çörək
bedroom	yataq otağı
week	həftəlik
flower	çiçək
negga	negga
egg	yumurta
walls	divan
travellers	səyahət edənlər
several	bir neçə
money	pul
care	qulluq
campsite	düşərgə
print	çap etmək
miami	miami
rather	əksinə
hear	eşitmək
desired	aralı
florence	güllələnmə
try	cəhd etmək
transportation	daşınma
booking	rezervasiya
pompidou	pompidou
think	düşünmək
apartment	mənzil
oriental	şərqşünas
seaside	dənizkənarı
port	port
books	Kitablar
yes	bəli
likewise	kimi
couldn	bacarmadı
score	hesab
sea	dəniz
afterwards	bundan sonra
residential	yaşayış
days	günlük
car	avtomobil
allows	imkan verir
didn	didişdi
there	orada
wil	istəmək
rear	arxa
amel	hərəkət
ignorant	cahil
breakfast	səhər yeməyi
staying	qalmaq
mostly	əsasən
right	haqlı
bike	velosiped
carpet	xalça
order	əmr
show	göstərmək
channels	kanallar
feeling	hiss etmək
hospitable	qonaqpərvər
handicapped	əlil
railway	dəmir yolu
coffee	qəhvə
registration	qeydiyyat
manicured	manilikdə
kettle	çaydanı
possibility	imkan
taken	qəbul
fact	fakt
itself	özü
finish	bitmək
public	ictimai
eyesi	Gözüaçıq
those	bunlar
restful	rahat
places	yer
requested	tələb olunan
garage	qaraj
importen	idxal
climbs	dırmaşmaq
looks	zəhlə tökmək
room	otaq
done	tamamlandı
catered	bəsləyən
underneath	altdan
charme	cadugərlik etmək
exceptionally	qanunauyğunsuz
alanani	Çalmaq
vice	vitse
helping	kömək
comfy	rahatlıq
sit	oturmaq
neightborhood	qonşuluq
warmbarman	istilaçı
blue	mavi
minibar	mikroavtobus
touring	gəzinti
street	küçə
6	Əqrəb
unmatched	miskinsiz
prefer	üstünlük vermək
delightful	ləzzətli
tourists	turistlər
happened	başıb oldu
marseillan	marseillan
ensures	təmin etmək
denmark	Danimarka
given	verilmiş
dogs	itlər
elysees	elysees
relatively	nisbətən
cars	avtomobillər
private	xüsusən
animations	animasiya
cooking	bişirilmə
westminster	qasırğa
careful	ehtiyatlı
travelodges	travan
just	cadarat
pull	çəkmək
miro	miro
especialy	xüsusilə
got	varlı
dedicaced	fədakarlıq
seen	görkəmli
stephanie	defani
thing	şey
average	orta
luxuries	lüks
everybody	hər kəs
ready	hazır
powerful	güclü
pleasantly	ləzzətlə
neighbourhood	qonşuluq
fist	yumruqlamaq
choice	seçim
sablon	Ekranı çap etmək
d	d
joy	sevinc
helpfull	faydalı
full	tam
awful	zəhmli
husband	ər
tube	boru
destinations	istiqamətlər
rose	yüksəltmək
employees	işçilər
â¬	â ası
bath	hamam
dark	qaranlıq
directions	istiqamətlər
slow	ləngitmək
owners	sahibkarlar
alphons	əlifba
nespresso	nespresso
visit	ziyarət etmək
recommendations	tövsiyələr
main	əsas
stay	qalmaq
attentive	diqqətli
constantly	daim
tell	söyləmək
found	tapdalamaq
2011	2011
metro	metro
conclusion	rəy
chldren	uşaqlıq
by	tərəfindən
reason	səbəb
least	ən azı
dislike	bəyənmədim
peopel	Xalq
volvereta	Volverteta
lock	bağlamaq
century	əsr
dana	dana
topaz	topaz
prado	prado
really	həqiqətən
pictures	şəkillər
living	canlı
m	m
neatly	səliqəli
advertised	elan olunan
activities	fəaliyyət
b	b
languages	dil
tennisfriends	tennisfriends
numerous	çoxsaylı
likely	ehtimal ki
weekenders	həftə sonu
grand	böyük
five	beş
build	tikmək
royal	kral
make	etmək
television	televiziya
drinks	içki
tasteful	zövqlü
kinds	tövləsi
cook	bişirmək
transfer	təhvil vermək
based	əsaslı
alternation	alternativ
re	cığırlamaq
tub	çəllək
ideal	ideal
wonderful	xoş
started	başlanğıc
cruise	kruiz
classiest	klassik
options	Seçimlər
rent	icarə
par	vasitəsilə
restrooms	tualet otaqları
facilities	qurğu
me	mənim
floor	döşəmə
reality	reallıq
agia	aqia
major	major
go	getmək
function	funksiya
breakfasts	Səhər yeməyi
unexpected	gözlənilməz
here	bura
enthusiastic	həvəsli
expectations	gözləntilər
inn	Mehmanxana
unconfortable	narahat
beaituful	Gözəl
ones	çoxlu
number	saymaq
true	doğru
practically	praktik olaraq
cant	ulant
nevertheless	buna qədər
trousers	şalvar
smile	gülümsəmək
trimphe	triomphe
cold	soyuq
impossible	qeyri-mümkün
felt	hiss etmək
pay	ödəmək
heart	qəlb
simplistic	sadəlövh
dansing	rəqs
start	başlamaq
chose	seçmək
exelent	əlacı
why	niyə
touristy	turistlik
both	hər ikisi
patient	salıb
bathing	çimmək
meal	yemək
game	oyun
unfriendly	qeyri-qənaətbəxş
this	bu
don	donuz
intersection	kəsişmə
germans	almeralar
generally	ümumiyyətlə
photos	fotoer
customers	müştərilərə
tuscany	tuskana
tho	tho
until	qədər
okay	tamam
cabinets	kabinetlər
mall	malal
items	maddələr
do	etmək
running	qaçış
almost	təxminən
chance	şövq
size	ölçü
convention	konvensiya
via	ilə
alley	xiyaban
rer	qamışlamaq
around	ətrafında
scam	fırıldaqçılıq
personal	fərd
ness	ness
foreign	əcnəbi
having	varlı
usually	adətən
till	üçün
vodka	voxka
miserable	bədbəxt
whose	kiminsə
âs	~ ~
dress	cılız
problems	problemlilik
hours	sair
terrible	dəhşətli
clean	təmizləmək
lifestyle	həyat tərzi
complex	mürəkkəb
snorkeling	snorkeling
small	kiçik
stayed	qalmış
top	üst
whenever	hər dəfə
allocated	ayrılmış
which	hansı
complain	şikayət
getting	əldə etmək
2010	2010
breathtaking	nəfəs kəsən
two	iki
putting	qoyulma
higher	ali
hte	ht
fashioned	moda
personnel	personka
yet	hətta
comfortablelounge	cevizi
south	cənub
decided	qərar
wish	arzulamaq
speaks	danışan
variuos	müxtəlif
games	oyun
floods	daşqın
twice	iki dəfə
where	harada
flamenco	flamenko
climb	dırmaşmaq
madrid	madrid
among	arasında
unless	nə olmasa
taking	alıb-alışmaq
staff	kadr
affordable	əlverişli
hilton	hilton
skype	skype
chosen	seçilmiş
reservation	rezervasiya
somewhere	haradasa
track	izləmək
awesome	zəhmli
reccomend	tövsiyə etmək
intrusive	müdaxilə
out	sönük
eat	yeyinmək
betting	bahis
accommodation	yerləşmə
appart	əlverişli
possitive	əla
restricted	məhdudlaşdırılmış
nevskii	Nevskii
advantadge	sərəncam
dine	sizin
mohamed	Məhəmətli
repeatative	təkrar
informed	məlumat
nicely	qəşəng
sleep	yatmaq
melia	melia
sunrise	günəşin doğuşu
otherwise	əks təqdirdə
minus	minus
lord	lord
visible	görünən
sunny	günəşli
2013	2013
pricey	bahalı
once	bir dəfə
covered	qapalı
positive	müsbət
cuase	səbəb olmaq
unbelievable	inanılmaz
mess	mess
13	Əqrəb
di	dən
age	yaş
disaster	fəlakət
â	â € ™
basin	hövzə
heated	qızdırılmış
team	komanda
distances	məsafə
spaces	fəzalar
smooth	hamarlamaq
impressed	heyranedici
purpose	mastika
cause	səbəb olmaq
boutiques	butiklər
welcomes	alqışlayır
inside	içəri
pizzeria	pizzacı
ground	torpaq
perfekt	Mükəmməlləşdirmək
unfortunately	təəssüf ki
olso	olso
stopped	dayandı
ago	əvvəllər
never	heç vaxt
paied	duru
quickly	sürətlə
feature	xüsusiyyət
program	proqram
charge	şarj etmək
her	onun
find	tapmaq
things	şey
beware	çəkmək
come	gəlmək
avoided	əlindənhayabənzər
animaters	animator
loud	ucadan
city	şəhər
eight	səkkiz
making	etmək
wc	Ayaqyolu
tea	çay
12	Əqrəb
bathroom	vanna otağı
kassandria	kassandria
flies	uçurmaq
reception	zəbt
manner	tərzə
years	illər
cultures	mədəniyyətlər
leisure	asudə
institute	institut
field	sahə
bacteria	bakteriya
legs	ayaqları
earned	qazanılmış
smelled	iylənmiş
petros	petroz
mean	demək
spotlessly	ləkəsiz
cool	sərinləşdirmək
been	baş
invited	dəvət
corridor	dəhliz
sheraton	şeraton
attractions	attraksion
shoes	ayaqqabı
garden	bağ
creaky	qıvrımlı
carparking	karpörtüşmə
rest	dincəlmək
oterwise	əks təqdirdə
quicker	yeyinti
smokers	siqaret çəkənlər
pathã©	pathã ©
flavouring	ətirli
space	yer
maximizes	maksimallaşdıran
namely	məhzun
requests	istək
downstairs	aşağı mərci
cleaness	təmizlik
preciseness	dəqiqlik
france	fransız
7th	Küsəyən
peoplethe	peoplete
trier	triper
scale	miqyaslı
lights	işıqlar
tower	qüllə
vip	vip
kept	saxlanılmaq
welcome	xoşnaş
dec	dekabr
person	şəxs
â	â € â €
chipped	qırxılmış
visited	ziyarəti
knowledgeable	bilikli
holidays	tətil
periferique	perifherique
everyone	hər kəs
giant	nəhəng
honor	fəxri
its	onun
swans	qaranquş
mexican	meksikalı
different	fərqli
steakhouse	steykouse
over	artıq
immediately	dərhal
degrees	dərəcə
reseption	zəbt
pool	hovuz
steigenberger	steigenberger
fresh	təravətli
coktailsstaff	coktailsstaff
pleasure	zovq
weeks	həftəlik
verry	silmək
entertaintments	avans
he	o
breathtaken	nəfəsalma
colorful	rəngarəng
nightclubs	gecə klubları
every	hər
recently	bu yaxınlarda
surrounding	ətraf
2014	2014-cü il
class	sinif
cologne	odun
persistent	israrlı
is	var
treated	rəftar
son	oğul
cancelled	ləğv edildi
points	xal
arrived	gəlmişkən
land	torpaq
luxurous	dəbdəbəli
created	yararlı
stationthe	stolüstü
stupid	beyinsiz
laying	yırğalama
lighting	işıqlandırma
kitchen	mətbəx
wonderfull	ecazkar
very	çox
roadside	yol kənarında
inspection	müayinə
interested	maraqlanan
underground	yeraltı
selection	seçmə
event	hadisə
defiantly	qətiyyətcə
part	qismən
possibly	bəlkə
sufficient	kifayət
centre	Mərkəz
colleagues	həmkarları
stores	sükan
connected	əlaqədar
star	ulduz
no	yox
croissants	kruvasan
urine	sidik
sray	Mehmanxana
efficiently	təsirli
cannot	kömək etmək olmur
remark	rəy
wall	divar
neighborhoods	məhəllə
diidn	imtina
gone	ardınca getdi
charm	cadugərlik etmək
tag	etiket
high	yüksək
had	varlı
budget	büdcə
seven	yeddi
interior	daxili
ship	gəmi
free	sərbəst
tidy	səliqəli
crazily	dəli-dəli
slendid	qamqal
friendliness	dostluq
necessary	zəruri
close	yaxın
calling	zəng
waits	gözləmək
invaded	işğal etmək
3am	general
bloody	qanlı
must	almalı
broken	qırıq
technology	texnologiya
provides	təmin edir
separated	ayrılmış
using	istifadə
furnished	mebelli
disgusting	iyrənc
stop	dayanmaq
light	işıq
fat	yağlı
held	keçirilib
more	daha çox
baku	Bakı
hence	bu səbəbdən
center	Mərkəz
ia	o
wear	taxmaq
since	o vaxtdan bəri
niuewstraat	Niuuewstraat
studio	studiya
etiquette	etiket
smiles	gülümsəmək
refund	qaytarmaq
nes	kimi
modest	təvazökar
letdown	lot
messe	messe
spot	ləkə
outstanding	görkəmli
town	şəhər
makers	yaraşananlar
mail	poçt
cafe	kafe
audience	tamaşaçı
quite	daban
excecutive	icraedici
so	belə ki
thus	beləliklə
mobile	mobil
connect	qoşulmaq
minded	fikirli
older	yaşlı
grandaughter	gülə etmək
rules	Qaydalar
desk	Yazı masası
â·	·
american	amerikan
hospitality	Qonaqpərvərlik
diner	yeməkxana
animation	animasiya
vieuz	viuzuz
breaks	pozğunluq
makes	edir
emily	emily
than	bundan daha çox
safe	seyf
escalator	eskalator
advantage	sərəncam
marvelous	ecazkar
front	cəbhə
balu	top
90	90
ride	Sürmək
suite	dəsgah
designed	tərtib edilmiş
passing	keçirici
down	aşağı
music	musiqi
month	ay
gladly	məmnuniyyətlə
schiphol	şiphol
key	key
touchwith	touchwith
guest	Qonaq
spirits	kef
stops	dayanacaq
comfort	rəğbət
inclysive	əhatəli
sure	əlimdən gəlmək
outdated	köhnəlmiş
attended	qatıldı
following	ardınca
hundred	yüz
has	var
hope	ümid
dorint	dorint
difficult	çətin
portions	hissə-hissə
jean	jean
tend	meyl etmək
afraid	qorxmaq
hell	cəhənnəm
a	bir
then	sonra
ihad	arzuolunan
5days	5 gün
delivery	çatdırılma
bit	bitişirin
leave	buraxmaq
away	uzaq
conference	konfrans
aside	kənara
definitively	qəti şəkildə
bigger	irigənc
beach	çimərlik
duty	vəzifə
forward	irəli
renovated	yeniləndi
stuff	ştamplamaq
nor	əqənnəm
alone	tək
pizza	pizza
walked	gəzəyən
need	ehtiyac
across	boyun
waiter	cavan
within	içərisində
position	mövqe
holiday	tətil
pants	şalvar
euro	avro
at	at
couple	cütləşmək
will	iradə
opinion	rəy
woerden	vox
tended	təhrikedici
renewed	yenilənmiş
shopping	alış-veriş
police	polis
country	ölkə
dusting	tozlanma
europe	Avropa
greatincredible	qüsurlu
services	xidmətlər
cleaning	təmizlənmə
tuscan	tuscan
talking	söhbət
forum	forum
triump	zəfər
miles	mil
visitor	qonaq
possibilties	fürsət
during	zərrə
hostel	hostel
shops	dükan
ample	yaman
candy	konfet
read	oxuyun
easily	asanlıqla
gorgeous	qəşəng
exact	dəqiq
gilde	gildiya
year	il
shadows	kölgələr
damage	zərər
aerobic	aerobik
cleaners	təmizləyicilər
midnight	gecə yarısı
min	mənim
discovery	kəşf
rotten	çürük
thinks	düşünür
nearly	təqribən
160	160
completed	tamamlanmış
an	bir
drink	içmək
mood	əhval
even	hətta
connection	qoşulma
offers	təklif
dolphin	delfin
35	35
takes	alıb-tutmaq
kind	mehriban
paradise	cənnət
does	edir
winter	qışqırmaq
meet	görüşmək
minuscule	minuslu
funiture	mebel
the	bu
disadvantages	dezavantajlar
cared	qayğıkeş
firenze	Güllələnmə
castelo	Qala
swimmingpools	uzguculuk hovuzu
louise	louise
absolute	mütləq
mr	Cənab
elysee	ellysee
what	nə
decoration	bəzək
surely	şübhəsiz
italian	italyan
mountain	dağ
ultra	ultra
laughed	güldürün
charming	cazibədar
greets	salam
behind	arxada
rocko	roko
second	ikinci
linen	kətan
highway	magistral
parking	dayanacaq
8th	8-ci
higly	hignly
buses	avtobuslar
sri	sri
anyone	hər kəs
exchanging	mübadiləsi
moments	anlıq
offering	qurban
everyday	hər gün
internet	internet
aerea	hava
wanted	istənilən
thessaloniki	Saloniki
spoiled	korlanmış
allow	icazə vermək
because	çünki
quick	cəld
hearts	qəlb
houses	evlər
eurostar	eurostar
charged	doldurulmuş
shows	şövqlü
aerobicthey	aerobicthey
prompt	tövsiyə etmək
â±	â â
coach	məşqçi
partner	tərəfdaş
suit	kostyum
adjusted	düzəldilmiş
sneaky	gizli
nights	gecələr
standards	standartlar
honeymooners	bal ayıçıları
hotel	otel
common	ümumi
beautifully	gözəl
alright	tam
met	görüşmək
london	london
spend	sərf etmək
tee	tee
let	buraxmaq
restaraunts	restoran
purposed	məqsədilə
aforesaid	yuxarıda deyildi
taught	öyrədilmiş
families	ailələr
byron	byron
sewage	kanalizasiya
concerning	bariz
hamam	hamam
mention	bəyan etmək
reached	nail olmaq
ideally	idealcasına
heavily	ağır
upgrade	təkmilləşdirmək
see	görmək
solved	həll edilmiş
helped	kömək
am	allah
spent	sərfəli
building	bina
recommendable	tövsiyə olunan
plenty	çox
flat	düz
strip	zollamaq
hole	dəlik
enjoyed	bəyənilmiş
standard	standart
complaints	şikayət
value	dəyər
cinema	kino
bussiness	bəxtlilik
except	bundan başqa
smaller	kiçik
jam	cam
electrical	elektrik
liverpool	fənərbət
totally	ümumən
ervery	hər
crazy	dəli
how	Necə
time	vaxt
relax	rahatlamaq
facilties	qurğu
fantastically	fantastikcəsinə
give	vermək
smiling	gülümsəyən
anybody	kimsə
balcony	balkon
adult	böyüklər
de	dən
professionell	peşəkar
these	bunlar
trying	cəhd etmək
ibis	ibqə
cover	örtük
like	kimi
much	çox
seine	onun
closer	yaxından
enter	girmək
providing	təminat
smallest	ən kiçik
passport	pasport
reply	cavab vermək
boulevar	bulvar bulev
spending	xərcləmə
assist	kömək etmək
tables	masa
unlike	fərqli
entertainment	zahir
