now	ADV
healthy	ADJ
kept	V
oasis	ADJ
nights	NNS
bridge	V
repeatative	ADJ
position	NN
coffee	NN
saw	V
been	V
byron	ADJ
pictures	NNS
trafford	V
marvelous	ADJ
royal	NN
linked	V
les	NNS
should	MD
accommodating	V
dark	V
domicile	NN
does	V
rated	V
lobby	NN
shows	NNS
ll	V
present	ADJ
houses	NNS
anybody	V
decent	ADJ
tube	NN
weekends	NNS
sercices	NNS
positive	ADJ
ridiculous	ADJ
pull	NN
expected	V
ansd	IN
hotelthe	NN
facilties	NNS
encountered	V
special	ADJ
nes	NNS
basic	ADJ
traffic	NN
spent	V
transportation	NN
miles	NNS
beaituful	ADV
aerobicthey	ADJ
field	NN
photos	NNS
am	V
beginning	V
kindly	ADV
boat	V
small	ADJ
siena	NNS
lovely	ADJ
part	NN
conditioning	V
tanning	V
advertised	ADJ
lanxess	NN
gym	NN
world	NN
swans	V
finish	ADJ
mood	NN
studio	NN
amsterdam	NN
double	ADJ
reccomend	NN
â	NNP
thank	V
400	CD
use	NN
inner	ADJ
students	NNS
needs	V
rest	NN
dana	NN
reason	NN
quite	ADV
over	IN
entertaintments	NNS
travellers	NNS
choose	V
age	NN
access	NN
therefore	ADV
18th	CD
spotlessly	ADV
major	ADJ
croissants	NNS
staff	NN
â·	NNP
nevskii	V
no	DT
surroundings	NNS
arrived	V
faded	ADJ
don	NN
repeat	NN
guest	ADJ
hand	NN
cheap	NN
childrens	NNS
reply	V
paris	ADJ
big	ADJ
chef	NN
shabby	NN
heated	V
stay	ADJ
acoustic	ADJ
literally	ADV
code	ADJ
location	NN
dream	NN
rubber	NN
importen	ADJ
order	NN
wife	NN
forward	ADV
current	ADJ
hard	ADJ
dj	NN
poor	ADJ
really	ADV
discounts	V
3am	CD
elevators	NNS
recomended	V
huge	ADJ
enmenons	NNS
paper	NN
size	NN
ask	NN
maximizes	V
tiling	V
fingerprints	NNS
damaged	V
alphons	NNS
chldren	V
extrasthe	ADJ
adequate	ADJ
realy	NN
pm	NN
finding	V
heating	NN
experienced	V
kitchen	NN
partner	NN
me	PRP
hole	ADJ
camp	ADJ
greets	NNS
excelent	ADJ
mgmt	NN
behind	IN
flower	ADJ
expense	NN
best	ADJ
death	NN
udaivilas	ADJ
pants	NNS
amazing	V
helpfulathe	NN
favorite	ADJ
paths	NNS
perfect	V
leaking	V
have	V
sunbeds	NNS
dec	ADJ
aren	ADV
connected	V
madrid	ADJ
zone	CD
machine	NN
nl	NN
pillows	V
sure	ADJ
cleaning	V
calm	ADJ
sports	NNS
centrally	ADV
relaxatio	V
refurnished	V
made	V
else	ADJ
insulation	NN
cigarette	NN
2012	CD
breathtaking	V
italien	ADJ
areas	NNS
tasty	ADJ
twice	ADV
making	V
unacceptable	ADJ
television	NN
super	ADJ
con	NN
dead	ADJ
seen	V
anymore	ADV
service	NN
seems	V
back	RP
got	V
singles	NNS
knowledgeable	ADJ
doesen	ADJ
dutch	NN
as	IN
worth	NN
travelled	V
requested	V
not	ADV
grandaughter	ADJ
hotels	NNS
old	ADJ
rer	NN
rear	NN
km	NN
meny	ADV
attentive	ADJ
live	ADJ
angry	ADJ
bedroom	NN
axaha	NN
priced	V
sauna	ADJ
distances	NNS
except	IN
other	ADJ
stupid	ADJ
insects	NNS
need	V
m	ADV
numerous	ADJ
funiture	NN
fantastic	ADJ
35	CD
family	NN
fi	NN
shops	NNS
deventer	V
spirits	NNS
jean	V
professionell	NN
dolphin	NN
offered	V
walked	ADJ
surprise	NN
passed	V
continue	ADJ
choice	NN
nearly	ADV
claiming	V
guests	NNS
park	ADV
wilderness	ADV
long	ADV
maintained	ADJ
key	ADJ
powerful	ADJ
elina	NNS
allocated	V
under	IN
looking	V
rail	NN
blocks	NNS
situated	V
pleasant	ADJ
neightborhood	NN
centre	NN
cracked	V
restourant	ADJ
territory	NN
needed	V
personal	ADJ
train	NN
inclusive	ADJ
frills	NNS
convention	NN
didn	ADJ
luxury	NN
dvd	NNS
surprised	V
160	CD
based	V
smallest	ADJ
aldo	ADJ
therethank	NN
elegance	NN
try	NN
liquires	V
couldn	ADJ
nearby	ADV
taken	V
slow	ADJ
bigger	ADJ
worn	ADJ
willing	ADJ
defiantly	ADV
cloth	V
grey	ADJ
public	ADJ
opera	NN
friendliness	NN
began	V
broken	ADJ
ride	ADJ
things	NNS
tornese	ADJ
police	NNS
almost	ADV
self	PRP
linen	ADJ
der	ADJ
professional	NN
set	NN
dust	NN
once	ADV
player	NN
bring	NN
beware	NN
ât	NNP
scale	NN
trained	V
liked	V
catered	ADJ
reality	NN
both	DT
lock	V
especially	ADV
february	ADJ
legs	NNS
pathã©	V
ideally	ADV
uncomfortable	ADJ
complaints	NNS
tower	V
scrambled	V
bad	ADJ
fish	ADJ
50	CD
instead	ADV
happened	V
bathrooms	NNS
greek	ADJ
welcomes	NNS
website	V
cleaned	V
across	IN
claustrophobic	NN
cocktails	NNS
tried	V
amstel	NN
champ	NN
definitively	ADV
sray	ADJ
15	CD
euros	NNS
gift	NN
impressed	V
closer	ADV
recommendable	ADJ
informed	ADJ
time	NN
electrical	ADJ
easy	ADJ
singer	NN
phone	NN
lamps	NNS
humid	NN
owners	NNS
intersection	V
disappointed	V
th	ADV
even	ADV
chance	NN
respective	ADJ
together	ADV
mostly	ADV
missed	V
stuff	NN
furnished	V
through	IN
insisted	V
also	ADV
espresso	ADJ
duck	NN
wait	NN
rank	NN
cottage	NN
fountain	NN
south	ADJ
hamburger	NN
revisiting	V
myself	PRP
scam	ADJ
subway	ADV
preciseness	ADJ
transfer	NN
campsite	ADJ
weekend	NN
cannot	NN
personally	ADV
transport	ADJ
canine	NN
beaches	NNS
washbasin	V
makes	V
deter	ADJ
girls	NNS
less	ADV
hotel	ADV
meet	V
simple	ADJ
near	IN
empty	ADJ
between	IN
building	V
disadvantages	NNS
prompt	V
mall	ADJ
beer	NN
builnding	V
video	NN
prepared	V
og	ADJ
nevertheless	ADJ
conditions	NNS
requests	NNS
disclose	V
starting	V
ready	ADJ
italian	ADJ
light	NN
remark	NN
visible	ADJ
track	NN
cycling	V
varieous	ADJ
cant	ADJ
topaz	NN
neatly	ADV
pizza	V
anna	ADJ
outside	IN
directions	NNS
till	IN
yourself	PRP
good	ADJ
storage	NN
lounge	NN
allows	V
smoking	V
finishes	NNS
grand	ADJ
stations	NNS
businesstrips	NNS
gran	V
exceptional	ADJ
deal	NN
bedding	V
prado	NN
seine	NN
liable	ADJ
served	V
extra	ADJ
totally	ADV
smooth	ADJ
bugs	NNS
tele	V
show	V
niuewstraat	ADJ
alternation	NN
providing	V
life	NN
towels	NNS
assoiated	V
disclosed	V
redeeming	V
everywhere	ADV
bath	IN
trying	V
ultra	ADJ
comforts	NNS
massive	ADJ
missing	V
relax	NN
tended	V
confortable	ADJ
extreme	ADJ
amel	ADJ
pleasure	NN
aerea	NN
cafe	ADJ
expectations	NNS
everyday	ADJ
nadia	ADJ
miss	NN
cooks	NNS
attractions	NNS
a	DT
fitnes	NNS
languages	V
delicious	ADJ
thoroughfare	NN
degrees	NNS
bit	V
cruise	ADJ
low	ADJ
stuck	NN
exposed	V
nicest	ADJ
international	ADJ
sea	NN
express	NN
booking	V
mistakes	NNS
mobile	ADV
delighed	V
improvement	NN
pleases	NNS
climbing	V
sastisfied	V
loved	V
d	NN
faulty	NN
ever	ADV
pretty	ADV
stops	ADJ
leaving	V
giant	ADJ
impressions	NNS
disadvantage	V
complaint	NN
right	NN
always	ADV
altstadt	ADV
steakhouse	NN
able	ADJ
confusing	V
outlet	NN
certainly	ADV
mohamed	V
suprised	ADJ
staircase	NN
foor	ADJ
several	ADJ
holiday	NN
became	V
versa	ADJ
computers	NNS
276	CD
think	V
floors	NNS
satisfied	V
appreciate	ADJ
course	NN
attended	V
flies	NNS
boy	V
dreamy	ADJ
grounds	NNS
peaceful	ADJ
robbed	V
allowing	V
ð¢his	ADJ
smiles	NNS
proffesional	ADJ
information	NN
24	CD
they	PRP
takes	V
carte	NN
program	NN
only	ADV
aquagym	V
amination	NN
detail	NN
candy	NN
of	IN
generous	ADJ
colleagues	NNS
travelodges	NNS
elevator	V
slippers	NNS
hear	V
to	TO
recomend	V
enjoyable	ADJ
renovarted	V
advise	NN
recommendation	NN
helped	V
careful	ADJ
morning	NN
though	IN
dogs	NNS
infrastructure	NN
unhappy	ADJ
summer	NN
enough	ADJ
responsibility	NN
chose	V
oterwise	ADJ
step	NN
an	DT
2013	CD
ideal	NN
came	V
shoping	V
example	NN
triump	NN
avoid	ADJ
advantage	NN
hussein	NN
groups	NNS
return	V
felt	V
find	ADJ
german	ADJ
afew	NN
âm	NNP
ther	CC
fast	ADJ
base	NN
san	ADJ
possibility	NN
minded	V
prefer	V
interesting	ADJ
christmas	NN
cheese	ADJ
older	ADJ
dubai	NN
amasing	V
check	NN
consider	V
ship	NN
purpose	NN
1300	CD
dish	NN
happiness	NN
received	V
mins	NNS
wonderfull	ADJ
floods	NNS
stores	NNS
comprehensive	V
working	V
exercise	NN
pools	NNS
inclysive	ADJ
map	NN
cozy	NN
sunrise	NN
pintxos	NN
thessaloniki	ADJ
thanks	NNS
enthusiastic	ADJ
immidiately	ADV
drain	V
balcony	ADJ
charged	V
different	ADJ
general	ADJ
reach	NN
wonderfully	ADV
busy	ADJ
affordable	ADJ
30	CD
12	CD
smelt	NN
fridge	NN
internet	NN
clean	ADJ
tide	IN
everything	NN
competent	NN
âd	NNP
times	V
cleanest	ADJ
having	V
palazzo	NN
wear	ADJ
ones	NNS
necessary	ADJ
peoplethe	NN
places	NNS
thomsons	NNS
massage	NN
midnight	V
someone	NN
end	NN
some	DT
serious	ADJ
sri	NN
paid	V
generally	ADV
offers	V
few	ADJ
reservation	NN
hour	NN
guys	NN
premises	NNS
thought	V
ã¡gent	ADJ
mamlouk	NN
station	NN
higher	ADJ
exchanging	V
koln	V
dirtyour	NN
boutiques	NNS
architecture	V
thrown	ADJ
75	CD
problem	NN
surf	NN
trees	NNS
volvereta	V
ms	ADJ
quick	ADJ
meal	NN
his	PRP$
tha	NN
butt	NN
repair	NN
transition	NN
300	CD
getting	V
summary	ADJ
typical	ADJ
found	V
day	NN
organised	V
online	ADJ
â±	NNP
martha	NN
marseillan	NN
is	V
sheets	NNS
expect	V
named	V
after	IN
tiny	ADJ
better	ADJ
hopping	V
1	CD
unique	ADJ
quickly	ADV
due	ADJ
type	NN
products	NNS
steam	V
3	CD
ã	NN
oliver	ADV
trier	ADJ
range	NN
helpfull	NN
afraid	ADJ
maximum	NN
b	NN
years	NNS
corner	V
splendid	ADJ
function	NN
however	ADV
rock	ADV
unfriendly	ADV
replinished	V
lanka	ADJ
pricey	NN
sunbed	V
conclusion	NN
whose	WP$
jacuzzi	NN
nicely	ADV
courses	V
shous	ADJ
wall	ADJ
continental	ADJ
two	CD
surprisingly	ADV
office	NN
wasnt	NN
assist	NN
hours	NNS
might	MD
feast	V
brought	ADJ
thing	NN
tub	NN
marvellous	ADJ
free	ADJ
management	NN
credit	NN
talking	V
pyramid	ADJ
25	CD
absolute	NN
walkways	NNS
getaway	V
beautifully	ADV
stares	NNS
olive	ADJ
france	NN
7th	CD
until	IN
fist	ADJ
place	NN
joy	NN
moved	V
trailer	ADJ
denmark	NN
those	DT
sã¶dermalm	ADJ
tp	ADJ
letdown	V
thoroughly	ADJ
reseption	NN
lyon	NN
admire	NN
quiet	ADJ
great	ADJ
if	IN
november	ADJ
1mile	CD
american	ADJ
probably	ADV
3rds	CD
plage	NN
toiletries	NNS
manner	V
eurostars	NNS
easily	ADV
wireless	IN
darling	V
apart	ADV
city	NN
twin	NN
setting	V
gone	V
supported	ADJ
weren	NNS
blend	V
nothing	NN
without	IN
will	MD
located	V
lagune	ADJ
â	NNP
gare	NN
word	NN
accustomed	V
seemed	V
creaky	ADJ
possible	ADJ
vodka	NN
gardens	NNS
stains	V
moments	NNS
interestingin	V
book	NN
fault	NN
verz	ADJ
residential	ADJ
dine	NN
every	DT
rain	NN
travelers	NNS
arc	V
t	NNS
take	V
par	NN
luxurious	ADJ
then	ADV
lousy	ADJ
wish	ADJ
aqua	NN
staying	V
spiderweb	NN
disgusting	V
created	V
trimphe	NN
egg	NN
turkey	NN
jumeriah	NN
pitch	NN
may	MD
holidaymy	V
lift	NN
en	IN
center	NN
walls	NNS
many	ADJ
pub	V
here	ADV
destinations	NNS
crowded	V
cleaness	ADJ
biggest	ADJ
friend	NN
night	NN
left	V
lunch	NN
did	V
chill	V
canal	ADJ
torn	ADJ
alive	ADJ
village	NN
miserable	ADJ
windows	NNS
alone	ADV
dorint	V
keys	NNS
especialy	V
reached	V
wine	NN
district	NN
has	V
10	CD
touristic	ADJ
site	NN
rate	NN
sofa	NN
villa	NN
about	IN
linens	ADJ
meetings	NNS
pleasantly	ADV
reserved	V
business	NN
surprising	NN
burger	NN
there	EX
normal	ADJ
children	NNS
employees	NNS
cereal	V
replenished	V
in	IN
lack	NN
nightclubs	ADJ
worries	NNS
terrific	V
borring	V
but	CC
swiming	V
pitches	NNS
maid	V
bloody	ADJ
needwe	ADJ
radio	NN
13	CD
mum	ADJ
cook	NN
provided	V
pre	ADJ
entertainment	NN
ration	NN
eyesi	NN
bussiness	NN
minutes	NNS
twist	V
specially	ADV
than	IN
give	V
delicacies	NNS
hof	V
suggest	ADJ
germans	NNS
rude	V
trash	ADJ
addition	NN
invaded	V
laughed	ADJ
diner	NN
attending	V
hell	NN
â´	NNP
climbs	NN
makers	NNS
hip	V
matter	NN
deskstop	NN
snorkeling	V
steigenburger	ADJ
ijust	ADJ
decorative	ADJ
number	NN
5days	CD
had	V
allwe	V
maybe	ADV
deserts	V
us	PRP
urine	ADJ
âs	ADJ
poland	NN
covered	V
true	ADJ
trip	NN
thursday	NN
let	V
trousers	NNS
welcomed	V
garden	ADV
allow	ADJ
space	NN
at	IN
choices	NNS
stopped	V
la	ADJ
halles	NNS
hearts	V
700	CD
returning	V
late	ADJ
enjoy	NN
meals	NNS
hurghada	V
active	ADJ
review	NN
taste	NN
absolutely	ADV
visiting	V
aerobic	ADJ
fact	NN
known	V
clerk	NN
compared	V
rungis	ADJ
tasteswe	NN
dancers	NNS
tidy	V
water	NN
top	ADJ
bus	NN
unforgettable	ADJ
square	NN
entertain	NN
non	IN
going	V
men	NNS
actual	ADJ
london	NN
hamam	NN
colors	NNS
construction	NN
warm	ADJ
steep	NN
including	V
resorts	NNS
restrooms	NNS
corridor	V
tuscan	ADJ
future	NN
restaraunts	NNS
people	NNS
eurostar	V
thats	NNS
speaks	V
hi	ADJ
attractive	ADJ
inedible	ADJ
months	NNS
requires	V
pluss	ADJ
animaters	NNS
welsh	V
spreads	NNS
louvre	ADV
extended	V
living	V
regular	ADJ
cleanliness	ADJ
price	NN
team	NN
famous	ADJ
flamenco	NN
note	NN
columbus	NN
schiphol	V
1st	CD
charm	NN
departure	NN
eg	V
unbelievable	ADJ
titanic	ADJ
request	NN
magical	ADJ
breakfast	NN
tennisfriends	NNS
superfriendly	ADV
main	ADJ
2011	CD
8th	CD
convenience	NN
etc	FW
six	CD
sheraton	NN
betting	V
rather	ADV
sit	ADJ
wery	NN
slendid	NN
from	IN
sleep	NN
finished	V
hosts	NNS
private	ADJ
inspection	NN
painting	V
load	NN
chosen	NN
date	NN
romantic	ADJ
floor	NN
cuisine	NN
terrace	NN
extremely	ADV
attention	NN
foreign	ADJ
champs	NNS
heard	V
week	NN
asked	V
wide	ADJ
largest	ADJ
assorted	ADJ
considering	V
kinds	NNS
chipped	V
spaces	NNS
minus	CC
smelled	V
was	V
something	NN
flight	NN
room	NN
recommended	V
opportunitys	ADJ
change	ADJ
century	NN
rambla	NN
waiters	NNS
speaking	V
buses	NNS
money	NN
local	ADJ
mini	NN
pot	NN
breakfasts	NNS
girl	V
out	RP
compact	ADJ
reasonable	ADJ
name	NN
animations	NNS
ness	ADJ
reception	NN
begrudge	NN
plenty	NN
offering	NN
character	NN
impression	NN
florence	NN
eat	NN
very	ADV
telling	V
carparking	V
blue	ADJ
planning	NN
placed	V
gaps	NNS
keep	V
game	NN
throughout	IN
explain	NN
russians	NNS
deprived	V
streets	NNS
visit	V
shoes	NNS
lots	ADV
likely	ADV
colorful	ADJ
food	NN
elegant	ADJ
suit	NN
were	V
highly	ADV
foods	NNS
olso	ADV
stained	V
variuos	NNS
gave	V
screen	ADJ
flag	NN
driving	V
unclog	ADJ
soon	ADV
bubba	ADJ
minibar	NN
checked	V
ignorant	ADJ
it	PRP
plays	V
okay	ADJ
wifi	NN
arrivals	NNS
vieuz	V
land	NN
bar	NN
animation	NN
person	NN
upgrade	ADJ
sunny	ADJ
bonus	NN
relatively	ADV
bed	V
passport	NN
coming	V
disaster	NN
milk	NN
eur	NN
immediately	ADV
air	NN
restricted	V
gets	V
within	IN
economically	ADV
menu	ADJ
cool	NN
restaurants	NNS
forced	V
helpful	ADJ
again	ADV
pension	NN
min	NN
prepare	NN
sell	V
piece	ADJ
chair	NN
ia	V
up	RP
why	WRB
immaculately	ADV
eran	V
off	RP
york	NN
marriott	NN
dishes	NNS
bliss	V
boring	V
invited	V
westminster	NN
respects	NNS
dusting	V
hostel	NN
solved	V
english	ADJ
40	CD
appart	ADV
mountain	NN
because	IN
notre	ADJ
nite	ADJ
cake	NN
yoghurt	NN
flughaven	ADJ
awesome	ADJ
given	V
handicapped	V
you	PRP
heater	V
unmatched	ADJ
realised	V
s	NN
octoberfest	NN
noticed	V
hospitality	NN
shopping	NN
redecorated	V
du	ADJ
creative	ADJ
ample	NN
anywhere	ADV
took	V
like	IN
adjacent	ADJ
shop	NNS
say	V
connect	ADJ
checkin	ADJ
rates	NNS
manager	NN
most	ADJ
suprise	NN
establishments	NNS
abundant	ADJ
go	V
diversity	NN
reliable	ADJ
gladly	ADV
charming	V
issue	NN
shame	NN
for	IN
average	ADJ
idea	NN
visits	NNS
disappointing	V
hoped	V
steak	ADJ
bacteria	NNS
luxurous	ADJ
touchwith	ADJ
tv	NN
mountains	NNS
first	ADV
impossible	ADJ
safe	ADJ
wg	NN
run	V
ingeniously	ADV
monmarte	ADJ
mention	NN
rat	NN
desert	NN
cover	NN
hope	V
fit	ADJ
april	NN
wi	NN
countryside	NN
argue	NN
renovation	NN
modern	ADJ
high	ADJ
10m2	CD
everybody	NN
7	CD
institute	NN
amount	NN
spend	V
improved	V
winter	ADV
excusive	ADJ
usually	ADV
picky	ADJ
railway	NN
standards	NNS
basin	V
breathtaken	V
call	NN
invite	ADJ
facility	NN
mould	MD
frienly	ADV
basically	ADV
window	ADJ
bathtub	NNS
fairly	ADV
exelent	ADJ
duty	NN
horrible	ADJ
heavily	ADV
somewhere	ADV
her	PRP$
baku	NN
stayed	V
favourite	ADJ
toast	NN
cabinets	NNS
finest	V
ad	NN
know	V
one	CD
vacation	NN
junior	NN
elysees	V
short	ADV
decided	V
booked	ADJ
putting	V
patient	ADJ
variety	NN
attitudes	NNS
vips	V
another	DT
teenagers	NNS
attitude	V
loveliest	ADJ
mail	NN
entire	ADJ
buiseness	NN
charge	NN
speak	NN
means	V
procedures	NNS
hostess	ADV
courteous	ADJ
lot	NN
month	NN
bright	V
we	PRP
sensational	ADJ
collapses	NNS
tables	NNS
second	ADJ
looks	NNS
line	NN
customers	NNS
timely	ADV
peopel	ADJ
opinion	NN
haque	NN
common	ADJ
stag	NN
diidn	ADJ
portions	NNS
everyone	NN
bookingcom	NN
desired	V
unexpected	ADJ
all	DT
more	ADV
grill	ADJ
advantadge	NN
look	NN
environment	NN
nightclub	V
their	PRP$
damage	NN
climb	NN
antic	ADJ
feeling	NN
considered	V
rent	NN
could	MD
ancient	V
orly	ADV
strongly	ADV
supburb	ADJ
escalator	NN
receptionists	NNS
described	V
usual	ADJ
roll	NN
extremly	ADV
flat	ADJ
cuddle	NN
love	V
which	WDT
14	CD
via	IN
smart	ADJ
frankfurtter	NN
metro	NN
unconfortable	ADJ
connections	NNS
full	ADJ
parking	NN
young	ADJ
customer	NN
rimini	NN
sun	NN
bread	NN
namely	ADV
last	ADJ
restaurant	NN
competences	NNS
who	WP
difficult	ADJ
accomodation	NN
seeing	V
care	NN
orders	NNS
odd	V
casino	NN
support	NN
nor	CC
eight	CD
reviews	NNS
highway	ADV
yet	ADV
pass	ADJ
nn	NN
anyway	ADV
bathroom	ADJ
milano	NN
luggage	NN
lights	NNS
cuase	NN
services	NNS
sewage	NN
exceptionally	ADV
buffet	ADJ
flamingo	NN
dat	NN
spacy	NN
hr	ADJ
flights	NNS
couples	NNS
four	CD
exceeded	V
bathrobes	NNS
airport	NN
market	NN
hospitable	ADJ
roadside	ADJ
families	NNS
crazily	ADV
backing	V
wheel	NN
used	V
riverside	V
how	WRB
while	ADJ
tea	NN
actually	ADV
delightful	ADJ
smokers	NNS
interested	ADJ
went	V
wellness	ADJ
large	ADJ
theres	NNS
espaccely	ADV
shelf	V
incredible	ADJ
iron	NN
wanted	V
ensures	NNS
nice	ADJ
friendy	V
spaciousthe	ADJ
dinner	NN
card	NN
educated	V
isolation	NN
items	NNS
traveling	V
stationthe	NN
bars	NNS
sufficient	ADJ
possibilties	NNS
hade	V
minuscule	ADJ
knew	V
level	ADJ
e	NN
cologne	NN
buy	NN
curtains	NNS
treatment	NN
taught	NN
possibly	ADV
tho	V
by	IN
prefect	NN
conveniently	ADV
2010	CD
package	NN
disabled	V
garage	NN
i	NN
goggle	V
leeds	NNS
way	NN
miami	NN
exact	ADJ
couple	NN
varieties	NNS
channel	V
pity	NN
department	NN
warmly	ADV
taxi	V
cold	ADJ
ago	ADV
managed	V
explore	ADV
downtown	ADJ
coktailsstaff	NN
robe	NN
utrecht	NN
atmosphere	ADV
cope	V
tasteful	ADJ
interior	ADJ
points	NNS
calimera	NN
balu	NN
reef	NN
cooking	V
done	V
see	NN
knowledge	NN
drink	V
pipes	NNS
neighborhoods	NNS
vehicles	NNS
decorated	V
visitor	ADJ
street	NN
stylish	ADJ
wil	NN
vip	NN
;	:
6	CD
ok	ADJ
vice	NN
weeks	NNS
activities	NNS
shower	V
renewed	V
cleaners	NNS
expensive	ADJ
smiling	V
scandic	ADJ
inn	NN
holidays	NNS
cancelled	V
work	NN
gobelins	NNS
holidys	V
organized	V
views	NNS
safety	NN
supermarket	NN
dorm	NN
bulgaria	V
functional	ADJ
likewise	NN
alley	NN
stays	V
weather	ADV
presented	V
spa	NN
vineyards	NNS
believe	V
happily	ADV
landscaped	V
tag	V
funny	ADJ
passing	V
doing	V
8	CD
where	WRB
receptionist	ADJ
personnel	NNS
hot	ADJ
selection	NN
husband	NN
visitors	NNS
info	V
arrival	ADJ
mainly	ADV
pizzeria	ADJ
side	NN
tallinn	NN
cause	NN
conference	NN
make	V
seats	NNS
feels	NNS
meat	NN
incredibly	ADV
barcelona	ADJ
heart	NN
stephanie	NN
condition	NN
evening	V
mixed	ADJ
pay	NN
come	V
weekday	ADJ
ervery	NN
stone	NN
egypt	NN
kã¶ln	NN
accommodation	NN
neighbourhood	ADV
akward	ADV
rocko	V
90	CD
star	NN
upper	ADJ
wouln	NN
mr	NN
since	IN
pompidou	NN
liverpool	NN
downstairs	ADJ
event	NN
spot	NN
handled	V
fee	NN
constantly	ADV
various	ADJ
lake	V
swipe	ADJ
wc	NN
rose	V
score	ADV
concerning	V
europe	NN
kuku	NN
stress	NN
she	PRP
nov	V
pond	NN
genuine	ADJ
system	NN
leisure	NN
on	IN
own	ADJ
that	IN
class	NN
worst	ADJ
toilet	NN
nationality	NN
quit	NN
conected	V
brits	NNS
welcomewould	MD
parts	NNS
much	ADV
dame	V
regard	NN
brocken	IN
touring	V
issues	NNS
books	NNS
cultures	NNS
mistake	V
shadows	NNS
chears	NNS
forum	V
moneyi	NN
facilities	NNS
mess	NN
dance	NN
aforesaid	V
rum	NN
included	V
unlike	IN
luxuries	NNS
floaties	NNS
frankfurt	V
disco	ADJ
superb	NN
separated	V
checking	NN
and	CC
vivaldi	NN
definitely	ADV
july	ADV
hall	ADJ
vast	ADJ
silent	NN
below	IN
climation	NN
them	PRP
cost	V
luxuryfood	NN
destroyed	V
add	V
kids	NNS
helping	V
advance	NN
de	IN
bike	FW
profession	NN
choises	NNS
blonde	V
louise	NN
started	V
yard	ADV
queue	NN
renovated	V
vas	ADJ
cinema	NN
travelodge	NN
unpleasantness	NN
smile	NN
using	V
yes	ADJ
throw	NN
just	ADV
layout	ADV
asian	ADJ
inexpensive	ADJ
perfectly	ADV
aside	ADV
beautiful	ADJ
weekenders	NNS
rotten	V
when	WRB
waits	NNS
paied	V
tuscany	ADJ
4	CD
available	ADJ
touristy	NNS
close	ADV
arena	V
alanani	NNS
so	ADV
refrigerator	ADJ
connection	NN
120	CD
job	NN
anything	NN
nespresso	ADJ
skype	NN
amenities	NNS
restaurat	V
channels	NNS
chairs	NNS
spakenburg	V
speed	NN
bland	NN
boulevar	NN
thick	NN
completed	V
start	ADJ
clubs	NNS
purposed	V
immediate	ADJ
paying	V
belongings	NNS
already	ADV
bathing	V
swimmingpools	NNS
changes	NNS
charme	V
oberoi	ADJ
certain	ADJ
azerbaijan	NN
travel	NN
bands	V
tournaments	NNS
dedicaced	ADJ
black	ADJ
tend	NN
ritz	NN
minute	NN
steigenberger	NN
tourists	NNS
costlier	V
never	ADV
golf	NN
held	V
get	V
comfy	ADJ
enjoyed	V
indeed	ADV
overpriced	V
with	IN
soap	NN
smaller	ADJ
year	NN
holland	NN
value	NN
y	NN
servings	NNS
verry	V
chic	ADJ
carlton	NN
structure	NN
stars	V
five	CD
stop	NN
warmbarman	NN
serve	V
roof	ADJ
organization	NN
european	ADJ
paradise	NN
housekeeping	NN
goes	V
complain	V
stolen	V
comfortable	ADJ
minimal	ADJ
confirmation	NN
sky	NN
arranged	V
mean	ADJ
during	IN
recommend	NN
unfortunately	ADV
awful	ADJ
breaker	NN
features	V
simplistic	ADJ
hotelmanager	NN
enterainment	NN
least	ADJ
smell	ADJ
loud	ADJ
trips	NNS
friends	NNS
narrow	ADJ
my	PRP$
luxor	ADJ
apartment	ADJ
new	ADJ
russian	ADJ
brandy	NN
feb	ADJ
ate	NN
each	DT
well	NN
attendance	NN
playground	NN
must	MD
polish	V
downside	ADV
2nd	CD
dirt	NN
earth	ADJ
coach	NN
provide	IN
underneath	NN
would	MD
pool	V
rebuilding	V
are	V
discovery	ADJ
following	V
shape	NN
pluspoint	ADJ
whole	ADJ
fun	NN
same	ADJ
homeless	NN
sneaky	NN
plan	NN
music	NN
hence	NN
amp	NN
comfort	NN
spoilt	V
seven	CD
tell	NN
costs	NNS
similar	ADJ
daytime	ADJ
observations	NNS
your	PRP$
lighting	V
river	NN
workers	NNS
design	NN
inside	ADV
built	V
shuttle	ADJ
excecutive	ADJ
boys	NNS
little	ADJ
hang	ADJ
cigarrum	NN
quicker	NN
refund	NN
taking	V
whenever	WRB
won	V
definetely	ADV
playing	V
break	V
agia	ADJ
standard	ADJ
persistent	NN
husaband	NN
can	MD
animators	V
before	IN
closes	NNS
round	V
such	ADJ
dress	NN
deira	NN
greatincredible	ADJ
avoided	V
chaos	NN
important	ADJ
proximity	NN
lord	NN
bikes	V
complex	ADJ
perfume	NN
waiter	ADV
directly	ADV
stunning	V
kettle	NN
far	ADV
recommendations	NNS
welcoming	V
travelling	V
holes	NNS
spending	V
words	NNS
case	NN
buildings	NNS
somewhat	ADV
problems	NNS
diffrent	ADJ
oversee	ADJ
underconstruction	NN
flavouring	V
suite	ADJ
kassandria	NNS
foot	V
â¬	ADJ
middle	ADJ
fine	ADJ
â	NN
build	NN
negga	IN
surrounding	V
seashore	ADJ
itself	PRP
reservations	NNS
into	IN
three	CD
rules	NNS
country	NN
resort	NN
ground	NN
comfortablelounge	NN
amp;	NN
petros	NN
happy	ADJ
swimmingpool	NN
relaxing	V
periferique	NN
builders	NNS
highlights	NNS
help	V
restful	V
swimming	V
elderly	ADJ
or	CC
sound	ADJ
town	NN
options	NNS
beach	V
visited	V
car	NN
2014	CD
hilton	NN
checkouts	NNS
underground	ADJ
provides	V
signal	ADJ
haven	NN
c	V
overal	ADJ
point	NN
walking	V
highways	NNS
jaccuzzi	V
anyone	NN
woerden	ADJ
drinks	NNS
spoiled	V
fabulous	ADJ
remind	NN
adjusted	V
elysee	ADV
cared	ADJ
destination	NN
experience	NN
intrusive	ADJ
firenze	NN
smoked	V
worse	ADJ
dislike	NN
home	NN
the	DT
dansing	V
convenient	NN
real	ADJ
still	ADV
hundred	V
contemporary	ADJ
offer	NN
trams	ADJ
relations	NNS
royalty	NN
among	IN
yaer	ADJ
table	ADJ
castelo	NN
gorgeous	ADJ
furniture	NN
honor	NN
tee	NN
heaven	ADJ
reasons	NNS
friendly	ADV
acceptable	ADJ
ve	ADJ
daily	ADJ
around	IN
restored	V
smelly	ADV
earned	V
pirates	NNS
surely	ADV
style	NN
euro	ADJ
distance	NN
situation	NN
budget	NN
smsevery	NN
technology	NN
fresh	ADJ
tasted	V
cusines	NNS
mexican	ADJ
dining	V
polite	ADJ
area	NN
next	IN
carpet	NN
30th	CD
equipment	NN
open	ADJ
option	NN
negative	ADJ
foyer	NN
above	IN
5	CD
troubles	NNS
picturesque	ADJ
door	ADJ
staffs	NNS
ibis	V
70s	CD
comparing	V
laying	V
dam	NN
pubs	NN
rooms	NNS
unclear	ADJ
interest	NN
decoration	NN
unless	IN
partying	V
said	V
print	NN
outdated	V
swim	NN
jammed	V
remember	ADJ
cottages	NNS
ours	V
beds	NNS
mother	ADV
fashioned	ADJ
be	V
vacationpickalbatros	ADJ
met	V
days	NNS
miro	ADV
feature	NN
completely	ADV
normally	ADV
quality	ADJ
persons	NNS
cross	V
state	NN
pleaseure	NN
freezing	V
march	NN
di	NN
overall	ADJ
glad	NN
moquette	NN
afterwards	NNS
n	ADJ
siro	ADJ
port	NN
montjuic	NNS
save	V
straight	V
originally	ADV
pantaneto	ADJ
registration	NN
early	ADV
dated	V
streetside	ADJ
modest	ADJ
executive	NN
excursions	NNS
oriental	ADJ
honeymooners	NNS
brussels	NNS
lifestyle	ADJ
view	V
what	WP
its	PRP$
lost	V
20	CD
9	CD
forthcoming	NN
vitosha	NNS
too	ADV
designed	V
surge	NN
spacious	ADJ
hte	NN
relaxed	NN
leave	V
worked	V
our	PRP$
juices	NNS
please	V
handle	ADJ
per	IN
wasn	ADJ
period	NN
bother	ADV
delivery	NN
talk	NN
wooden	NN
sorted	V
idem	ADJ
snorkelling	V
audience	NN
noticeable	ADJ
timing	V
members	NNS
plus	CC
kind	NN
accompanied	ADJ
concept	NN
trouble	NN
recently	ADV
although	IN
welcome	NN
he	PRP
nord	V
adult	NN
brilliant	ADJ
fat	ADJ
son	NN
efficiently	ADV
practically	ADV
steps	ADJ
length	NN
higly	ADV
etiquette	ADJ
efficient	ADJ
read	V
tram	IN
despite	IN
adults	NNS
feel	V
emily	ADV
bilbao	ADV
possitive	ADJ
dirty	NN
road	NN
mice	NN
complained	V
residents	NNS
secure	ADJ
meters	NNS
montmartre	V
noisy	ADV
varied	V
safisfied	ADJ
tourist	NN
running	V
cars	NNS
commonly	ADV
entrance	V
frequent	ADJ
hermitage	NN
excellent	ADJ
enter	NN
correspond	NN
behold	ADJ
weekly	ADJ
usd	NN
seaside	ADJ
central	ADJ
otherwise	ADV
simply	ADV
games	NNS
crazy	ADJ
club	NN
sasha	V
any	DT
kallithea	NN
ihad	NN
house	NN
bass	NN
apartments	NNS
kindness	ADJ
thinks	NNS
re	V
gold	NN
mangers	NNS
strip	V
perfekt	NN
treated	V
messe	NN
equipped	V
calling	V
disappointment	NN
outstanding	ADJ
noice	NN
marinachania	NN
tastes	V
association	NN
gilde	NN
2	CD
saff	NN
desk	NN
terrible	ADJ
sharm	NN
breaks	NNS
palace	V
down	RP
sablon	ADV
fantastically	ADV
this	DT
alright	NN
fully	ADV
noise	ADV
whisky	ADJ
tip	NN
looked	V
mega	ADJ
copenhagen	NN
scenic	ADJ
backpackers	NNS
match	V
recent	ADJ
george	NN
these	DT
front	V
spoken	ADJ
classiest	NN
fitness	NN
manicured	V
casa	ADJ
wonderful	ADJ
thus	ADV
plaesantly	ADV
maker	NN
walk	NN
want	V
do	V
being	V
melia	V
away	ADV
jam	ADJ
egypts	NNS
locate	V
french	ADJ
