maintained	vzdrževana
smallest	najmanjši
les	The
bussiness	Pobudba
tell	povej
nicest	najlepše
perfume	parfum
periferique	perifernica
nights	Noči
both	oboje
your	Tvoja
done	Končano
touristic	Turistic.
doing	delam
ready	pripravljen
bookingcom	Bookingcom.
price	Cena
handle	ročaj
supermarket	supermarket.
recommend	Priporoči
languages	Jeziki
eurostar	Eurostar.
cusines	kuhinje
joy	veselje
guest	gost
fountain	fontana
reccomend	Priporočamo
came	prišel
she	ona
sensational	senzacionalna
might	morda
italian	Italijanščina
organization	organizacija
biggest	največji
world	World.
miss	zgrešiti
when	kdaj
arrival	Prihod
lot	lot.
taste	okus
messe	messe.
served	postrežen
eg	npr
trying	poskušam
long	dolga
smsevery	SMSERY.
smiles	nasmeh
exceptionally	izjemoma
â·	Â ·
wouln	Wouln.
leaking	puščanje
de	Od
meters	metrov
experience	izkušnje
parts	deli
rebuilding	obnovo
exercise	Vaja
allowing	Omogoča
wasnt	Wasnt.
type	Tip.
luxury	Luxury.
tide	plima
groups	skupine
created	Ustvarjeno
dream	Dream.
not	ne.
completely	Popolnoma
persistent	vztrajno
stuff	stvari
fat	Fat.
brussels	Bruselj
code	Koda
m	M.
insulation	izolacija
7th	Hut.
very	zelo
udaivilas	Udaivilis.
weather	Vreme
professional	strokovnjak
n	n
knew	vedel
ingeniously	iznajdljivo
finished	Dokončano
barcelona	Barcelona
restaurat	obnovljena
building	stavba
gift	darilo
complex	kompleks
visitor	obiskovalec
gladly	z veseljem
street	Street.
functional	delujoč
bridge	most
line	vrstica
robbed	oropati
ll	ll.
life	življenje
excusive	neupravičeno
moments	trenutki
tp	TP.
given	Glede na to
160	160.
visited	obiskan
daily	dnevno
matter	materija
dance	Ples.
television	Televizija
surely	zagotovo
non	ne
chipped	Carped.
restourant	Restavracija
prefect	prefekt.
christmas	Božič
saw	videl
have	imajo
hundred	sto
welcomes	pozdrav
general	General.
bedding	posteljnina
due	Zagotovljeno
mould	plesen
restricted	Omejeno
least	vsaj
traffic	promet
fitnes	fitnes.
it	to
swimming	plavanje
pot	pol
gold	zlato
heater	grelec
helping	Pomoč
hr	Hr.
unbelievable	Neverjetno
encountered	naletel
outside	zunaj
relax	sprostite se
alive	živ
package	paket
400	400.
corner	kotiček
conclusion	Zaključek
boutiques	butiki
excecutive	Executive.
educated	izobraženi
feeling	občutek
avoid	Izogibajte se
mall	Mall.
jaccuzzi	Jaccuzzi.
suprise	preseči
friendy	prijatelj
juices	Sokovi
international	International.
mother	mati
delicious	slasten
cultures	kulture
damage	poškodbe
melia	Melia.
solved	SOLVED.
site	stran
belongings	vnašajo
everybody	vsem
minuscule	minuscule.
kitchen	kuhinja
collapses	zruši
office	Office.
buffet	bife
easily	enostavno
sauna	savna
quicker	hitreje
sofa	kavč
maybe	morda
deventer	Deventer.
diner	Diner.
comfort	Comfort.
enterainment	Zabava
serious	resen
pleasure	užitek
sheets	listov
please	prosim
distances	razdalje
rest	počitek
easy	Easy.
areas	območja
goggle	goggle.
sit	SIT
unique	edinstven
ultra	Ultra.
sharm	Sharm.
tasty	okusno
aerobic	AEROBIC.
has	ima
attendance	prisotnost
separated	ločeno
word	Beseda
â	â € ™
smart	Smart.
slendid	Poljanje
hamburger	Hamburger.
well	dobro
welcomed	dobrodošel
kinds	Vrste
colleagues	kolegi
service	Service.
creative	CREATIVE.
expensive	drago
connected	povezan
enmenons	Enmens.
milk	Mleko
minimal	minimal.
actual	dejansko.
common	običajni
confusing	zmedeno
bus	avtobus
destroyed	uničen
twin	Twin.
system	Sistem
â¬	€
espaccely	epaccely.
speak	govoriti
lack	Pomanjkanje
scrambled	Umešano
forward	naprej
whisky	Whisky.
narrow	ozko
reservations	Rezervacije
relaxatio	sprostitev
open	odprto
sneaky	Sneaky.
aforesaid	prej
2014	2014.
bathtub	kad
luxurious	razkošno
think	Think.
named	Imenovan
vas	vas
despite	Kljub
gare	Postaja
jumeriah	Jumeirah.
varied	raznovrstno
plenty	Veliko
on	On.
soon	Kmalu.
avoided	izogniti
vitosha	Vitosha.
present	Predstavitve
opinion	Mnenje
internet	Internet.
spakenburg	Spakenburg.
pluss	plus.
boring	dolgočasno
south	Južno
fully	Popolnoma
grill	žar
average	Povprečje
18th	18.
fantastic	Fantastično
continental	Continental.
timing	časovni okvir
sun	Sonce.
decorated	okrašena
anyone	kdorkoli
stylish	Eleganten
fault	Napaka
uncomfortable	neudobno
twice	dvakrat
books	Knjige.
pictures	slike.
they	oni
make	Make.
cold	hladno
map	zemljevid
wilderness	divjina
pathã©	PATH ©
hospitality	gostoljubnost
â	â € "
inclusive	vključujoče
builnding	stavba
mice	Mice.
escalator	Escalator.
girl	dekle
recommended	priporočeno
residential	stanovanjsko
denmark	Danska
speaking	govorjenje
incredible	neverjetno
having	the
yoghurt	jogurt.
amel	akcija
absolutely	popolnoma
surroundings	okolica
cuase	vzrok
activities	dejavnosti
riverside	Riverside.
teenagers	Najstniki
euros	evro
blocks	blokov
morning	zjutraj
bit	bit.
moved	premaknjeno
living	živeti
position	Položaj
up	gor.
part	del
find	najti
manner	način
that	to
contemporary	Sodobna
six	šest
perfectly	popolnoma
floors	Tla
steak	zrezek
tried	poskusil
problem	problem
crowded	gneča
inner	notranji
helpfulathe	Pomoč
been	bil
breathtaken	dih
vodka	vodka.
welsh	velejenje
plan	Načrt
animaters	Animatorji
repeat	ponovite
forum	Forum.
stops	ustavi
november	november
underneath	pod njim
grandaughter	Veseljenja
ever	kdaj.
lovely	Lovely.
our	Naša
dust	prah
roll	Roll.
covered	pokriti
registration	Registracija
taxi	taksi.
different	drugačen
tallinn	Tallinn.
rent	Najem
tha	bom
information	Informacije
trip	potovanje
chef	kuhar
hang	Hang.
here	tukaj
spirits	žganja
best	najboljši
management	Upravljanje
review	Opis.
balcony	balkon
worked	delal
relatively	relativno
likely	verjetno
those	Tisti
stays	Estays.
peaceful	mirno
cope	obvladati
job	Job.
hermitage	Hermitage.
try	poskusite
ibis	ibis.
beaituful	Lepo
correspond	ustreza
house	Hiša
daytime	dan
seine	njegov
stupid	neumno
efficient	Učinkovito
possible	mogoče
portions	Deli
ve	in
active	Aktivna
hole	luknja
disco	disco.
come	pridi
cannot	ne morem
straight	naravnost
chair	Predsednik
cook	Cook.
costlier	Costlier.
reseption	recepcija
downside	navzdol
2013	2013.
smelly	smrdljivo
cottages	Počitniške hiše
torn	raztrgano
mum	mama
dine	Tvoja
start	start.
river	reka
spaciousthe	prostoren
already	že
higher	Višje
which	to
suggest	predlagam.
repeatative	ponavljajoč
butt	Butt.
replinished	dopolnjen
twist	Twist.
deserts	puščave
advise	svetovanje
basin	bazen
lanxess	Langess.
last	Zadnja
tasted	okus
no	ne
kindly	prijazno
desk	Desk
conditioning	kondicioniranje
conference	Konferenca
minutes	Zapisnik
houses	hiše
disclosed	razkrije
honor	čast
large	Velika
elevators	dvigala
comfy	udobno
else	drugega
refurnished	Robrite
requests	Zahteve
buiseness	Poslovanje
literally	dobesedno
kindness	prijaznost
sell	prodaj
lamps	svetilke
destinations	destinacije
want	želite
as	sodišče
choose	Izberite
negga	negga.
pipes	Cevi
laughed	Smejal se je
pitch	višina tona
fun	zabava
linens	posteljnina
â	â € œ
other	drugo
nevskii	Nevskii.
clerk	urark
upgrade	nadgradnja
royalty	Royalty.
online	na spletu.
star	zvezda
enjoy	Uživajte
website	Spletna stran
each	vsak
so	tako
coktailsstaff	Coktailsstaff.
hall	hodnik
champs	Champs.
safety	Varnost
highway	Avtocesta
therefore	zato
shoes	čevlji
jean	Jean.
situated	se nahaja
grand	Grand.
2012	2012.
ours	naša
tower	stolp
fast	Hitro
bloody	krvavo
cars	Cars.
center	center
slow	počasi
down	dol
unclog	Unglag.
booking	Rezerviraj
less	manj
15	15.
far	Daljno
bring	prinesi
smooth	gladka
mountain	Mountain.
eat	jesti
t	T.
floor	tla
handicapped	Handicaped.
proximity	Bližina
genuine	pristno
eyesi	OČI
brits	Brits.
behind	zadaj
nes	sodišče
men	moški
could	lahko
interest	obresti
silent	tiho
helped	pomagal
weekday	Tedna dan
guys	fantje
class	razred
tho	tho.
shoping	nakupovanje
likewise	prav tako
varieties	sorte
staffs	Osebje
touchwith	touchwith.
bonus	bonus.
dancers	plesalci
love	ljubezen
concept	Koncept.
services	storitve
would	bi
en	v
july	Julij.
seats	sedeži
immediate	takoj
faulty	napačen
reserved	Rezervirano
freezing	Zamrzovanje
importen	Uvažanje
dutch	Nizozemščina
2nd	2.
meet	srečati
cigarette	cigareta
downstairs	spodaj
french	Francozi
koln	Koln.
bar	bar
hopping	skok
about	približno
working	delo
weekenders	Vikends.
behold	glej
du	Od
dorm	Dorm.
linen	perilo
something	nekaj
flights	Letalo
wonderfully	čudovito
be	BE.
can	lahko
unpleasantness	neprijetnost
cake	Cake.
discovery	odkritje
homeless	Brezdomci
warm	toplo
seashore	obala
pompidou	Pompidou.
a	A.
timely	pravočasno.
baku	baku.
informed	obveščen
bathing	kopanje
tag	oznaka
even	Celo
during	med
ð¢his	ð ¢ njegov
myself	jaz
checkouts	Checkouts.
and	in
safe	sef.
shuttle	shuttle.
marvellous	čudovito
basically	v bistvu
similar	Podobno.
shous	čevlji
give	da
computers	Računalniki
necessary	potrebno
awesome	super
florence	Firence
shower	tuš
warmbarman	WarmBarman.
talk	Pogovor
charged	zaračuna
woerden	woerden.
overpriced	previsok
square	Square.
wooden	Lesena
highlights	Poudarki
unlike	Za razliko od
planning	Načrtovanje
inclysive	vključujoče
than	od
rank	Rank.
wine	Vino
ijust	jaz samo
quality	Kakovost
crazy	Crazy.
germans	Nemci
for	za
surf	Surf.
casa	Hiša
age	Starost
di	Od
appart	Appart.
happiness	Sreča
channels	kanale
blend	mešanica
stayed	ostal
equipment	Oprema
restaurants	restavracije
print	Natisni
chose	izbral
palazzo	Palazzo.
stuck	Stuck.
advertised	oglaševano
dislike	ne marajo
good	dobro
departure	odhod
serve	Postrezite
character	znak
nadia	nadia.
food	hrane
complaint	pritožba
travelling	Potovanje
aerobicthey	aerobicthey.
specially	posebej
nationality	državljanstvo
cool	kul
request	prošnja
let	pustiti
road	cesta
note	Opomba
renovarted	Preusmerjena.
renovation	Obnova
you	ti.
â´	«
russians	Rusi
liquires	likerji
who	WHO
coming	prihaja
certainly	zagotovo
âs	â € ™ s
disadvantages	Slabosti
;	;
charme	čar
betting	Stave
landscaped	urejeno
organised	organizirano
recomend	Pripomoček
hour	uro
these	te
location	Lokacija
wish	želja
use	uporaba
order	Naročilo
trafford	Trafford.
km	km.
prado	prado
wheel	kolo
year	leto
possibilties	možnosti
seaside	Seaside.
shame	sramota
interior	notranjost
balu	žogo
worries	skrbi
field	polje
casino	Casino.
nov	november
spotlessly	brez sramu
partner	Partner.
scandic	Scandic.
directions	Navodila
extremely	zelo
table	Tabela
gorgeous	krasen
liable	Odvigacija
provides	prispeva
state	država
close	Zapri
largest	največje
recently	Nedavno
attention	Pozornost
especialy	Še posebej
top	Vrh
steps	korakov
poland	Poljska
attractions	Znamenitosti. \ T
cooking	Kuhanje
exelent	exelent.
minus	minus.
scale	Lestvica
cleaning	Čiščenje
receptionist	receptor
neatly	lepo
exposed	izpostavljeni
vivaldi	Vivaldi.
emily	Emily.
excelent	Excelent.
immediately	takoj.
5days	5 dni
railway	Železniški promet
normally	Običajno
lake	jezero
we	smo
real	Real.
meat	Meso
ideally	Idealno
exceeded	presežena
bedroom	Spalnica
went	šel
egypts	Egipt
mountains	gore
yard	Yard.
verz	verz
checked	preverjen
guests	Gostom
la	The
still	še vedno
1	Mesto 1.
pantaneto	Pantaneto.
missing	manjka
tidy	Urejeno
pub	gostilna
little	malo
chairs	stoli
manager	Upravitelj
dubai	Dubaj
crazily	grozljivo
radio	radio.
amazing	neverjetno
vieuz	vieuz.
camp	Kamp
lost	izgubljen
negative	negativno
rather	raje
akward	nerodno.
duck	Duck.
need	Potreba
thick	debela
machine	stroj
decided	odločil
vice	vice.
lock	Zaklepanje
issue	težava
courteous	vljuden
remark	Opomba
plays	igra
s	S.
place	Kraj
robe	boobe.
og	in
egg	jajce
probably	verjetno
using	z uporabo
trousers	hlače
destination	nadati
gilde	Guild.
disappointment	razočaranje
charm	čar
view	Pogled
people	Ljudje
york	York
generally	na splošno
heaven	nebesa
hand	roka
strip	trak
expected	pričakovano
europe	Evropa
dirt	umazanija
eran	bilo
trams	Trams.
evening	večer
remember	Zapomni si
score	rezultat
vacationpickalbatros	HowayPickalbatros.
don	ne
beware	Pazite
always	nenehno
curtains	zavese
resorts	letovišča
fantastically	fantastično
dirtyour	Dirtyour.
friends	prijatelji
th	th.
staircase	stopnišče
rear	zadaj
sray	Gostilna
keys	Keys.
spiderweb	pajkova mreža
oliver	Oliver.
build	graditi
conveniently	Udobje
ignorant	nevedni
keep	Hraniti.
streetside	STREEPSIDE.
choice	izbira
stone	kamen
restaurant	Restavracija
period	obdobje
lift	dvig
foot	stopala
never	nikoli
aqua	Aqua.
discounts	Popusti
anything	karkoli
rocko	Rocho.
option	možnost
chance	priložnost
clean	čisto
interesting	Zanimivo
ancient	starodavno
vacation	počitnice
attitude	Odnos.
6	6. 6.
coffee	kava
students	študente
short	kratek
titanic	titanik
scam	prevara
funny	smešno
convenient	priročno
saff	Layer.
yet	mesto
ride	Ride.
complained	se je pritožil
save	Shrani
peoplethe	peoplet.
break	premor
lord	Gospod
trained	usposobljeni
sure	zagotovo
holiday	Počitnice
9	9.
signal	Signal.
coach	trener
of	Od
read	preberite
toiletries	toaletne potrebščine
needwe	potrebujem
layout	postavitev
pitches	parcele
y	Y.
tele	tele
diffrent	drugačna
tube	Tube
hard	težko
leisure	prosti čas
lobby	Predverje
alley	Alley.
entertaintments	Značilnosti
described	opisano
supburb	sunburb.
delighed	z veseljem
ervery	vsak
businesstrips	Businessprippe.
meny	Meni
picturesque	slikovito
swiming	plavanje
budget	Proračun
girls	dekleta
pm	pm
traveling	Potovanje
rates	cene
fact	dejstvo
90	90.
peopel	Ljudje
humid	vlažno
home	doma
sri	Sri.
cafe	kavarna
sablon	Tiskanje zaslonske slike
rat	podgana
1mile	1mile
commonly	pogosto
cared	skrbel
customer	stranka
speed	Hitrost
generous	velikodušno
wery	Wery.
pleases	z veseljem
vips	VIPS.
value	vrednost
black	Črna
front	Front.
three	tri
tram	tramvaj
dirty	umazano
again	ponovno
eurostars	Eurostars.
helpfull	Pomavalo
designed	oblikovan
big	Big.
enter	vnesite
swipe	potegnite
splendid	čudovito
because	Ker
drinks	Pijače
asian	asian
miles	milje
reviews	Ocene
2010	2010.
local	lokalno
tastes	okus
amasing	amasing.
welcoming	pozdravljam
therethank	Therethank.
really	res
wellness	Wellness.
varieous	Vasieous.
inedible	neužiten
throughout	Skoraj
spoken	govorjeno
visiting	obisk
ones	tisti
feast	pojedina
any	kaj
own	lastnik
families	družine
restful	pomirjeno
cocktails	Cocktails.
is	je
day	Dan
ration	obrok
advantadge	prednost.
reef	greben
do	do
earth	Zemlja
shabby	Shaby.
kã¶ln	KÃ¶ln.
environment	okolje
normal	normalno
wc	stranišče
paths	poti
thats	to
rungis	Rungis.
per	Per.
waits	čaka
maid	služkinja
mega	mega.
2011	2011.
hearts	srca
stay	Ostanite
cleaness	Čistost
smaller	manjša
luxuryfood	Luksuzna sama
suite	Suite.
into	v.
boulevar	Boulevar.
hospitable	gostoljubno
smile	nasmeh
every	vsak
scenic	Scenic.
shape	obliko
connections	Povezave
amp;	AMP;
years	let
kids	otroci
swimmingpools	plavalni bazeni
ritz	ritz.
by	po
chears	TURCES.
bathrooms	kopalnice
land	zemljišče
lunch	kosilo
driving	Vozite
tuscany	TUSCANY.
architecture	Arhitektura
convenience	udobje
ideal	Idealno
available	na voljo
kept	hraniti
dat	To
various	različno
awful	grozno
dana	Dana.
being	biti
incredibly	neverjetno
holidaymy	Počitniška
vehicles	vozila
ground	tla
candy	sladkarije
swimmingpool	bazen
recomended	Priporočamo
express	Express.
carte	kartica
construction	Gradnja
reality	realnost
pay	Pay.
sheraton	sheraton.
enjoyed	uživa
executive	Executive.
number	številka
am	am.
waiter	natakar
thoroughfare	THEROUSHARE.
district	District.
allows	omogoča
14	14.
travelled	potoval
exceptional	izjemno
fist	pest.
3am	General.
tee	tee.
alone	sam
nespresso	Nespresso.
cleaners	Čistila
music	glasba
cabinets	omare
only	Samo
altstadt	Altstadt.
chldren	otroci
tiling	polaganje
surrounding	Okolica
yes	da
possibly	morda
paris	Paris.
design	oblikovanje
thoroughly	temeljito
program	Program.
acoustic	akustično
assoiated	povezan
holidys	Počitnice
10	10. 10.
walked	hodil
romantic	Romantic
visible	viden
technology	Tehnologija
apart	Apartma
staying	ostati
competent	Pristojen
kuku	Nail.
polish	Polish.
chaos	Chaos.
just	Samo
accompanied	spremlja
week	Teden
back	nazaj
impossible	nemogoče
catered	Poskrbi
8	8. 8.
via	VIA.
wide	širok
hamam	kopel
attractive	privlačen
75	75.
time	čas
paper	papir
games	igre
welcome	Dobrodošli
lagune	laguna
famous	slavni
walkways	Walkways.
yaer	WHO
stress	stres.
flower	cvet
redeeming	unovčenje
spaces	Prostori
tanning	Tanning.
needed	potrebno
take	vzemi
older	Starejši
quickly	hitro
affordable	cenovno dostopne
orders	naročil
too	tudi
requires	zahteva
toilet	WC
hotelmanager	HotelManager.
montjuic	Montjuic.
dusting	prašenje
terrace	Terrace.
couples	pari
okay	v redu
said	je rekel
cruise	križarjenje
reason	Razlog
hoped	upal
gone	Gone.
mexican	mehiški
stationthe	Stationthe.
dorint	Dorint.
pleasantly	prijetno
weeks	tednov
neighbourhood	okolico
worse	slabše
thing	stvar
standard	Standard.
game	Igra
four	štiri
swim	plavati
workers	delavci
century	Century.
running	teče
shows	prikaže
colorful	barvita
surprise	presenečenje
places	polji
cheese	Cheese.
bugs	Bugs.
travelodge	Travelodge.
purposed	namerno
sound	Sound.
elegant	eleganten
toast	toast.
luxurous	razkošno
france	Francija
goes	Gos.
roof	streho
within	znotraj
recommendation	Priporočilo
town	mesto
small	majhna
private	zasebno.
points	Točke
noisy	Noisy.
13	13.
gave	Dave.
reach	REACH.
supported	Podprto
practically	praktično
luxor	Luksor.
sunny	sončno
prepare	Pripravite se
broken	zlomljeno
locate	poiščite
dress	Obleka
european	Evropska
began	začel
tuscan	TUSCAN.
bad	slab
maker	ustvarjalec
meal	obrok
adjusted	Prilagojen
cigarrum	Cigarrum.
dogs	Psi.
received	prejeto
absolute	absolutno
closes	Zapre
cost	stane
odd	Čuden
case	Ovitek
brilliant	briljantno
etiquette	etiketa
channel	kanal.
new	novo
event	Dogodek
claustrophobic	claustrofobic.
recommendable	Priporočljivo
somewhat	nekoliko
flavouring	aroma
smiling	nasmeh
e	E.
hte	hme
look	Poglej
whenever	vsakič
police	Policija
restaraunts	restavracije
variety	sorte
dvd	DVD.
horrible	grozno
attentive	Pozorno
nord	sever
live	Živi
get	Pojdi
strongly	močno
fitness	fitnes.
noticed	opazil
menu	Meni
interested	zanima
dec	Dec.
bland	Bland.
through	skozi
originally	originalno
corridor	koridor
costs	stroškov
husaband	Havend.
or	ali
arrived	Prišel
reliable	zanesljiv
leeds	Leeds.
prepared	pripravljen
wg	v
busy	zaseden
everything	vse
see	Glejte
full	poln
disaster	nesreča
didn	ni bilo
storage	shranjevanje
ã	Ã-
some	nekaj
acceptable	Sprejemljivo
early	Zgonu
simple	Enostavo
steigenburger	Steigenberger.
anybody	kdorkoli
bass	bass.
infrastructure	infrastruktura
an	An.
magical	čarobno
held	VREDNO
though	čeprav
finish	Finish.
way	pot
helpful	koristno
offers	Ponudba
the	The
hope	upam
allow	Dovolite
ok	v redu
plaesantly	plezitno
thrown	vržen
shops	Trgovine
speaks	govori
restrooms	Sanit
shadows	Shadows.
wanted	želel
weekends	vikendi
style	Style.
setting	nastavitev
respects	spoštuje
brought	pripeljal
show	Pokaži
noticeable	opazen
urine	urine.
looking	Iskanje
condition	pogoj
favourite	Najljubši
drain	Drain.
tea	čaj
choices	izbira
recent	Nedavno
fit	FIT.
consider	UPOŠTEVAJTE
reached	dosegel
had	je imel
greek	Grk
stopped	ustavil
hostess	Hostesa
right	prav
situation	situacija
looked	Pogledal
complain	pritožba
martha	Martha.
grounds	razlogi
employees	zaposleni
climation	Podingding.
breathtaking	dih jemajoče
hade	imel.
amstel	amstel.
neighborhoods	soseske
playing	igranje
lighting	osvetlitev
montmartre	Montmartre.
renovated	prenovljen
kassandria	Kassandria.
golf	Golf
confirmation	Potrditev
downtown	Downtown.
renewed	obnovljena
seemed	zdelo se je
trimphe	Triomphe.
flies	muhe
dining	jedilnica
mail	Mail.
walk	hoje
airport	letališče
village	Vas.
damaged	poškodovana
pubs	pubi
shopping	Nakupovanje
he	On.
sea	morje
cracked	cracked.
dedicaced	predanost
smelled	vonjal
superfriendly	superfriendly.
them	njim
haven	haven
par	skozi
towels	brisače
future	Prihodnost
diidn	Zavrnitev
nor	NOR.
efficiently	učinkovito
louise	Louise.
variuos	različno
spa	SPA.
seems	se zdi
24	24.
forced	prisiljen
difficult	težko
london	London.
rain	dež
possibility	Možnost
allocated	dodeljena
tended	vodenje
streets	ulice
excellent	Odlično
buildings	stavbe
items	Postavke
childrens	otrok
once	enkrat
moneyi	moneyi.
delicacies	Delikacije
complaints	Pritožbe
stores	trgovine
antic	preteklost
diversity	raznolikost
7	7. 7.
usual	običajno
midnight	polnoči
luggage	Prtljaga
together	skupaj.
my	moj
thursday	Četrtek
welcomewould	pozdravljam
suprised	presenečenje
nite	Nite.
superb	Superb
hosts	gostitelji
offered	ponujen
unexpected	nepričakovan
makes	naredi
opportunitys	priložnosti
leave	dopust
recommendations	Priporočila
all	vse
away	proč
euro	evro
1300	1300.
everywhere	povsod
metro	Metro.
steam	pare
pity	usmiljenja
whole	Celoss
getting	Getting.
deal	Deal.
westminster	Westminster.
smokers	Kadilci
frills	Frills.
months	mesecev
steigenberger	Steigenberger.
rose	Rose.
someone	Nekdo
trier	Trier.
touristy	Turistična
sasha	sasha.
countryside	podeželje
invaded	Inpaded.
pretty	lepa
pricey	Price
trees	drevesa
owners	Lastniki
arena	arena
overall	Na splošno
needs	Potrebe
studio	studio.
pirates	Pirates.
appreciate	cenim
buy	kupite
mamlouk	mamlouk.
mess	nered
colors	Barve
marseillan	Marseillan
animation	animacija
dam	jez
liverpool	Liverpool.
treated	zdravljeni
afew	nekaj
wear	nositi
decorative	Dekorativna
eur	EUR
paid	plačano
extreme	ekstremno
bother	moti
minibar	Minibar.
ther	THER.
relaxing	sproščujoče
mostly	večinoma
apartments	Apartmaji
walking	hoditi
tub	Tub.
premises	prostori
rail	Rail.
player	Igralec
elderly	starejših
cuddle	Cuddle.
money	denar
vast	obsega
mean	pomeni
connect	Connect.
roadside	cesti
business	Poslovanje
tasteful	Okusno
unfortunately	Na žalost
enjoyable	prijetno
hotelthe	Hotel The..
screen	Zaslon
1st	1.
friendliness	prijaznost
major	major.
example	primer
upper	Zgornji
everyday	vsak dan
constantly	nenehno
personally	osebno
rude	nesramen
experienced	izkušeni
among	med
across	čez
dark	temno
reservation	Rezervacija
reception	recepcija
found	najdemo
wil	hočem
pizza	pizza
2	Mesto 2.
arranged	urejeno
steakhouse	Steakhouse.
in	v
rer	hitenje
typical	tipično
repair	Popravilo
summer	poletje
are	so
pluspoint	PlusPoint.
pillows	blazine
greets	pozdravi
amount	Znesek
preciseness	Natančnost
quiet	tih
procedures	postopke
classiest	klasično
card	kartica
foods	živila
der	The
versa	Versa.
weren	Oddelek
fabulous	čudovito
cuisine	Kuhinja
should	naj
were	bilo
bikes	Bikes.
adjacent	sosednja
thessaloniki	Solun
unconfortable	neudobno
impression	Vtis
putting	dajanje
cycling	kolesarjenje
looks	izgleda
30	30.
step	korak
piece	kos
delivery	Dostava
aside	na stran
gym	telovadnica
mistakes	Napake
tend	nagibati se
favorite	Najljubši
february	Februarjem
facility	objekt.
adult	odrasli
from	Od
surprisingly	presenetljivo
there	Tam.
garden	vrt.
following	naslednje
nearby	V bližini
entertain	zabavati
noice	NOICE.
fine	globa
fee	FEE
definitely	definitivno
abundant	obilno
key	Key.
directly	neposredno
centrally	centralno
its	To je
glad	vesel
faded	zbledel
prompt	Poziv
will	volja
expectations	pričakovanja
second	drugič
confortable	udobno
pyramid	piramida
while	medtem
simplistic	Poenostavljeno
bigger	večji
help	Pomoč
level	ravni
run	Run.
maximizes	maksimizira
heavily	močno
seen	videl
anna	Anna.
admire	občudovati
decent	dostojnik
addition	Dodatek.
hell	Hell.
volvereta	Volvera.
greatincredible	velikancrible.
taking	jemanje
her	njena
waiters	natakarji
products	izdelki
tables	tabele
returning	vračanje
redecorated	preurejeno
connection	Povezava
adults	odrasli
worst	najslabše
person	oseba
expect	pričakovati
eight	osem
around	okoli
linked	Povezano
invited	Povabljena
accommodation	Nastanitev
floaties	Plovbe
taught	učil
verry	verry.
nice	lepo
dishes	Posode
choises	izbira
flamingo	flamingo.
spend	porabite
lights	Luči
market	Trg
times	časov
hilton	Hilton.
train	vlak
rambla	rambla.
calling	klic
breakfast	zajtrk
theres	theres.
bulgaria	Bolgarija
except	Razen
laying	polaganje
cleaned	očiščen
rated	ocenjeno
700	700.
point	točka
was	Je bilo
check	Preverite
highways	avtocesta
inside	notranjost
wireless	Brezžično
ms	gospa
defiantly	dokaz
rum	rum.
compared	v primerjavi
match	ujemanje
subway	podzemna
staff	Osebje
friendly	prijazno
hot	Vroče
with	Z.
over	nad
department	Oddelek
beautiful	Lepo
competences	kompetence
including	vključno z
although	čeprav.
nevertheless	Kljub temu
refund	povračilo
deira	deira.
pass	Pass.
facilties	Objekti
builders	Builders.
ness	ness.
decoration	dekoracijo
oriental	Oriental
ihad	zaželeno
accustomed	navajen
equipped	Opremljena
this	to
aren	areen.
meals	obroki
anywhere	kjerkoli
happened	se je zgodilo
3	Mesto 3.
mini	mini.
paying	plačilo
work	Delo
inexpensive	poceni
â±	Â Â ±
accomodation	Nastanitev
poor	slabo
bike	kolo
jacuzzi	jacuzzi.
regard	spoštovati
space	PROSTOR
feature	funkcijo
rock	Rock.
to	To.
territory	Ozemlje
inn	gostilna
bands	Bands.
canine	pasjino
disappointing	razočaranje
asked	vprašal
anymore	več.
surprised	presenečen
boat	čoln
quit	prenehati
met	srečal
unforgettable	nepozabno
huge	ogromen
adequate	ustrezen
institute	Inštitut.
notre	Naša
holland	Nizozemska
royal	Royal.
painting	slika
nl	nl.
special	poseben
breakfasts	zajtrk
self	self.
treatment	Zdravljenje
mistake	napaka
sewage	kanalizacija
turkey	puran
partying	zabavo
cottage	Počitniška hiša
if	če.
higly	higly.
spoilt	razvajen
elina	elina
respective	ustrezni
empty	prazno
skype	Skype.
thinks	misli
light	Light.
cheap	poceni
simply	preprosto
kind	prijazna
lifestyle	Lifestyle.
options	opcije
weekend	vikend
climbs	vzpenjač
distance	razdalja
late	pozen
queue	čakalna vrsta
earned	zaslužil
improved	izboljšal
central	Central.
travelodges	Travelodges.
outdated	zastarela
breaks	zlomi
vineyards	vinogradi
c	c.
outstanding	Neporavnano
return	Vrnite se
legs	noge
cinema	kino
wait	počakati
paradise	raj.
foreign	tuje
side	Stran
high	High.
electrical	Električna
another	drugo
at	At.
nothing	nič
underground	podzemlje
two	dva
russian	ruski
massage	sporočilo
views	Ogledi
etc	itd
worn	obrabljena
flag	oznaka
super	super.
8th	8.
dolphin	Dolphin.
photos	Fotografije
basic	Osnovno
realy	res
heated	ogrevan
deter	deterder.
apartment	Apartma
where	kje
aerea	Aerial.
manicured	Manicured.
placed	postavljena
unmatched	neizravnano
maximum	največje
loveliest	Najlepše
sorted	razvrščeni
off	Off.
exact	Točka
rotten	Rotten.
pleasant	Prijetno
frienly	Prijazno
beautifully	lepo
careful	previden
booked	rezervirano.
tornese	Tornese.
bars	palice
deprived	prikrajšan
secure	Secure.
stares	gleda
perfect	Perfect.
possitive	Positive.
dead	mrtev
extended	podaljša
month	mesec
foyer	Foyer.
brocken	Brocken.
unacceptable	nesprejemljivo
five	pet
giant	velikan
hence	Zato
now	zdaj
comparing	Primerjava
middle	sredina
kallithea	kallithea.
minded	misleči
mainly	predvsem
stations	Postaje
below	spodaj
ridiculous	smešno
afterwards	nato
professionell	strokovnjak
carpet	Carpet.
spacious	prostorna
carlton	Carlton.
burger	Burger.
animations	animacije
hip	kolk
creaky	ŠTEKY.
âm	â € ™ m
mood	razpoloženje
frankfurtter	Frankfurter.
wonderfull	čudovito
itself	sama
organized	organizirano
idea	Ideja
next	Naslednji
marvelous	čudovito
makers	oblikovalci
stained	obarvana
visits	obiskov
enough	dovolj
reply	Odgovori.
courses	tečaji
alright	vredu
opera	Opera.
washbasin	umivalnik
takes	Po potrebi
prefer	raje
somewhere	nekje
replenished	dopolnjen
positive	Pozitivno
cologne	Köln
boys	fantje
after	Po tem
loved	ljubil
disclose	razkriti
actually	Pravzaprav
remind	spomin
stains	madeži.
date	Datum.
support	Podpora
offering	Ponudba
credit	kredit
fish	Ribe
10m2	10m2.
without	brez
desert	puščava
usually	običajno
known	znano
provided	zagotovljeno
spot	Spot.
transfer	Prenos
centre	center
dish	Dish.
able	sposoben
honeymooners	Mladoporočenci
cereal	žit
area	območje
healthy	Zdravo
meetings	Srečanja
pintxos	Pintxos.
customers	Kupci
san	San.
noise	Hrup
nicely	lepo
room	Soba
function	Funkcija
course	tečaj
byron	byron.
iron	Iron.
sleep	Spanje.
under	Spodaj
petros	Petros.
columbus	Columbus.
con	Z.
smoked	kadil
selection	izbor
ansd	Ansd.
allwe	Allwe.
immidiately	takoj.
idem	enako
kettle	Grelnik vode
invite	povabi
furnished	opremljeno
stop	ustavi
nearly	skoraj
charge	napolniti
70s	70 X.
hear	Poslušajte
furniture	Pohištvo
forthcoming	Prihodnost
jam	Jam.
feels	občutek
true	prav
impressions	Vtisi
steep	strmo
did	je
pull	Poteg
afraid	strah
however	vendar
backpackers	Backpackers.
flamenco	flamenco.
instead	namesto tega
liked	všeč
sunbeds	SunBeds.
exchanging	izmenjava
call	Pokliči
provide	zagotoviti
window	okno
summary	Povzetek
beginning	Začetek
must	Must
dansing	Ples.
modern	Moderna
made	narejen
fresh	svež
schiphol	Schiphol.
30th	30.
george	George.
attended	obiskoval
ã¡gent	ÀGen.
sufficient	dovolj
knowledge	znanje
25	25.
siena	siena.
tourist	Turist.
assorted	izbrana
hurghada	Hurghada.
grey	siva
neightborhood	okolico
observations	opazovanja
miami	miami.
servings	obroke
comprehensive	. \ T
priced	Cena
ago	nazaj
conected	povezan
bath	kopel
realised	realizirana
care	nega
throw	metati
set	Set.
providing	Nudenje
finding	Iskanje
touring	Touring.
housekeeping	gospodinjstvo
air	zrak
access	dostop
persons	osebe
polite	vljudni
agia	Agia.
unless	razen
blue	modra
important	pomembno
concerning	o tem \ t
wifi	Wifi
villa	Villa.
pre	Pre.
mobile	Mobile.
know	vedeti
problems	težave
comfortable	udobno
300	300.
almost	Skoraj
amsterdam	Amsterdam.
wasn	ni bil
transportation	Transport.
atmosphere	atmosfera
isolation	izolacija
mgmt	mgmt.
got	dobil
happy	srečna
standards	Standardi
troubles	Težave
âd	â € â € ™ D
heard	slišal
transition	prehod
b	B.
climb	vzpenjati se
terrific	Trup.com
darling	Draga
base	base.
comforts	udobje
disabled	onemogočeno
dame	dame.
boy	fant.
team	Ekipa
also	tudi
refrigerator	hladilnik
totally	popolnoma
heating	Ogrevanje
leaving	Odhod
zone	cona.
us	nam
closer	bližje
park	parkirati
cleanest	najčistejši
paied	paed.
cant	ne morem
impressed	impresioniran
degrees	Stopnje
hi	hi.
shelf	Slica
alternation	izmenjava
advance	Advance.
warmly	toplo
phone	Telefon
gran	Super
chill	Chill.
rooms	Sobe
louvre	Louvre.
spending	Poraba
bacteria	Bakterije
suit	. \ T
intrusive	vsiljiv
funiture	Pohištvo
disappointed	razočaran
surprising	presenetljivo
terrible	grozno
resort	letovišče
mr	gospod
moquette	Carpet.
conditions	pogoji
features	Lastnosti
winter	zima
friend	prijatelj
elysee	Elysee.
stolen	ukraden
aquagym	Aquagym.
smelt	Smallt.
hotels	hoteli.
trips	TRIPS.
picky	izbirčen
oversee	nadzoruje
members	člani
entrance	vhod
shop	Trgovina
add	Dodaj
detail	podrobnosti
felt	Felt.
vip	VIP.
canal	kanal
first	najprej
ask	Vprašaj.
trash	trash.
palace	Palača
bathrobes	kopalni plašči
knowledgeable	dobro
length	Dolžina
stag	Stag.
extremly	Izjemno
cover	Pokrov
advantage	prednost.
fridge	Hladilnik
gets	Gets.
arrivals	Prihod
me	me
port	Port.
track	Track.
re	re.
size	Velikost.
proffesional	strokovnjak
comfortablelounge	ComfutableLounge.
built	zgrajeno
delightful	čudovito
water	voda
wife	žena
monmarte	Montmartre.
elegance	Elegance.
pizzeria	Pizzeria.
inspection	Inšpekcija
oasis	Oasis.
plage	Plaža
thomsons	Thomsons.
miro	miro.
otherwise	drugače
completed	dokončan
junior	mlajši
angry	jezen
between	med
especially	Še posebej
establishments	ustanove
used	uporabljeno
gaps	vrzeli
rubber	guma
feb	februar
mixed	mešano
flat	stanovanje
letdown	razočarati
free	prost
charming	očarljivo
responsibility	odgovornost
fashioned	oblikovan
restored	obnovljena
italien	Italija
couldn	ne bi mogel
convention	konvencija
blonde	blondinka
cancelled	prekinjeno
accommodating	sprejem
frankfurt	Frankfurt.
indeed	prav zares
structure	struktura
nightclub	nočni klub
telling	povedati
finishes	konča
haque	haque.
utrecht	utrecht.
their	Njihov
like	kot.
enthusiastic	navdušena
mohamed	Mohammed.
singles	Singles.
50	50.
parking	Parkiranje
worth	vredno
massive	zelo veliko
left	levo
fi	BE.
copenhagen	København
unclear	nejasen
unhappy	nesrečen
tennisfriends	Tennisfriends.
wi	In
chic	CHIC.
travelers	Potniki
stunning	omamljanje
out	ven
requested	zahtevano
attitudes	stališče
ia	On.
cloth	Tkanina
explore	Raziščite
spreads	Namazi
attending	Potrjevanje
extrasthe	Ekstrasthe.
receptionists	receptorjev
whose	čigar
egypt	Egipt.
current	Tok
luxuries	Luxuries.
profession	poklic
satisfied	zadovoljni
better	bolje
ate	jedel
cozy	cozy.
same	enako
halles	Halles.
miserable	nesrečen
calimera	Calimera.
most	večina
holidays	Počitnice
happily	srečno
pension	Penzion.
lousy	slaba
climbing	plezanje
end	konec
fairly	pošteno
smell	vonj
personnel	osebje
deskstop	DeskStap.
octoberfest	oktoberfest.
marinachania	marina
trailer	Trailer.
insisted	vztrajal
till	To.
handled	ravnanje
desired	želeno
quite	precej
thank	HVALA
bathroom	kopalnica
such	tak
continue	Nadaljujte
amenities	udobja
elevator	dvigalo
nightclubs	Nočni klubi
flughaven	Letališče
double	double.
travel	potovanje
near	v bližini
safisfied	zadovoljni
brandy	Brandy.
pool	Pool.
drink	pijača
city	mesto
cleanliness	Čistost
passed	sprejel
slippers	copate
economically	gospodarsko
foor	Foor.
country	država
night	noč
snorkeling	potapljanje z masko
madrid	Madrid.
pools	bazeni
insects	žuželke
stars	zvezde
included	Vključeno
aldo	Aldo.
definitively	dokončno
carparking	CARSARKING.
ât	â € ™ t
spacy	spacce.
since	od
old	star
wonderful	čudovito
lanka	Lanka
visit	Obiščite
orly	Orly.
info	Info.
quick	QUICK.
mins	Mins.
compact	Compact.
stephanie	Stephanie.
travellers	Potniki
bliss	blaženost
borring	Bring.
issues	vprašanja
oterwise	drugače
beer	pivo
clubs	Klubi
passing	mimo
won	Won.
lyon	Lyon.
took	je
tip	Nasvet
video	Video.
personal	osebna
cause	vzrok
calm	mirno
reasonable	Razumno
espresso	espresso.
expense	strošek
breaker	Breaker.
range	območje
presented	predstavljeno
until	Do.
perfekt	Perfect.
checkin	Prijava
his	njegov
feel	občutek
pleaseure	užitek
snorkelling	snorkel
tasteswe	okuswe.
gobelins	gobelins.
heart	srce
above	nad
husband	mož
5	5. 5.
everyone	vsi
argue	trdijo
association	Združenje.
assist	pomoč
ad	ad
definetely	definitivno
backing	Podpora
disadvantage	pomanjkljivost
visitors	Obiskovalci
tv	TV.
say	reči.
getaway	Pojdi stran
triump	Triumph.
bilbao	Bilbao.
surge	Surge.
chosen	izbran
interestingin	Zanimivo
excursions	Izleti
audience	občinstvo
animators	Animatorji
garage	garaža
ample	veliko
but	zvezek
facilities	Objekti
passport	Potni list
nn	nn.
round	kroga
doesen	doesen.
jammed	zagozda
thought	mislil
reasons	razlogov
purpose	Namen
sky	Sky.
elysees	elysees.
windows	Windows.
ship	ladje
usd	ameriški dolar
explain	Pojasnite
arc	lok
more	več.
change	Spremeni
namely	namreč.
taken	vzeti
why	zakaj.
before	prej
improvement	izboljšava
cooks	Kuharji
underconstruction	v izgradnji
unfriendly	neprijazno
what	kaj
mention	omeniti
35	35.
smoking	kajenje
tourists	turisti
patient	potrpežljiv
station	Postaja
making	izdelava
olso	OLSO.
march	pohod
seeing	vidim
3rds	3.
hussein	Hussein.
bright	Bright.
hof	hof.
public	javno.
ensures	Zagotavlja
highly	zelo
starting	Začetek
beaches	plaže
campsite	Kamp
minute	minuto
milano	Milano.
days	dnevi
considering	upoštevanje
english	angleščina
topaz	Topaz.
low	nizka
20	20.
thanks	HVALA HVALA
revisiting	Revising.
based	temelji
axaha	ElB.
go	pojdi
going	Going.
considered	obravnavana
young	mlajši
relaxed	sproščeno
castelo	Grad
claiming	trditev
bed	postelja
pants	Hlače
dreamy	sanjy.
started	začel
lots	veliko
frequent	Pogosto
main	main.
thus	zato
changes	spremembe
things	stvari
couple	par.
club	Club.
trouble	Težava
modest	skromna
begrudge	begrudge.
book	Book.
azerbaijan	Azerbajdžan
pond	ribnik
alanani	Gumb
fingerprints	prstni odtisi
powerful	močan
gardens	vrtovi
talking	Talking.
many	Mnogi
hostel	Hostel
certain	zagotovo
missed	zamudil
may	maj
one	eno
dated	Dated.
willing	pripravljen
german	Nemščina
entertainment	Zabava
spent	preživel
april	april
car	avto
mangers	Mangers.
40	40.
load	Load.
i	jaz
intersection	križišče
duty	dolžnost
several	več
numerous	številne
amination	aminacija
siro	Siro.
managed	upravlja
believe	verjeti
domicile	domicile
located	se nahaja
beach	plaža
yourself	sami
seven	sedem
extra	dodatno
floods	poplave
marriott	Marriott.
transport	Transport.
tiny	Tiny.
bubba	bubba.
rimini	Rimini.
swans	Swans.
tournaments	turnirji.
anyway	vseeno
cross	križ
sunbed	ležala
sports	šport
dinner	večerja
holes	luknje
276	276.
sunrise	Sunrise.
d	D.
residents	prebivalci
lounge	Lounge.
words	Besede
finest	Finest.
few	nekaj
spoiled	razvajen
singer	Singer.
means	pomeni
much	veliko
rate	oceniti
12	12.
flight	Let
offer	Ponudba
checking	preverjanje
relations	Odnosi.
120	120.
son	sin
how	kako
oberoi	Oberoi.
plus	plus.
wall	zid
walls	Stene
american	ameriški
sastisfied	zadovoljni
sã¶dermalm	sÃ¶dermalm.
became	postati
then	potem
olive	Olive.
champ	Champ.
does	dogaja
regular	redno.
family	družina
weekly	Tedensko
dj	dj.
children	otroci
name	Ime
amp	amp.
4	4. 4.
firenze	Firence
hotel	Hotel.
min	me
great	Super
hours	ure
alphons	Alphons.
playground	igrišče
death	smrt
niuewstraat	NIUUEWSTRAAT.
outlet	Outlet.
loud	glasno
immaculately	nemašeno
overal	povsod
bread	kruh
soap	milo
disgusting	ogabno
door	vrata
sercices	storitve
beds	Postelje
croissants	rogljički
rules	pravila
buses	Avtobusi
