now	nu
healthy	friska
kept	bevarad
oasis	oas
nights	nätter
bridge	bro
repeatative	repetitiv
position	placera
coffee	kaffe
saw	fick syn på
been	var
byron	byron
pictures	bilder
trafford	trafford
marvelous	underbar
royal	kunglig
linked	länkad
les	de
should	skall
accommodating	tillmötesgående
dark	mörk
domicile	hemvist
does	göra
rated	rankad
lobby	lobby
shows	visar
ll	ll
present	närvarande
houses	hus
anybody	vem som helst
decent	anständig
tube	rör
weekends	helger
sercices	tjänster
positive	positiv
ridiculous	löjlig
pull	dra
expected	förväntad
ansd	ansn
hotelthe	hotell
facilties	anläggningar
encountered	påträffade
special	särskild
nes	som
basic	grundläggande
traffic	trafik
spent	tillbringade
transportation	transport
miles	miles
beaituful	Skön
aerobicthey	Aerobicthey
field	fält
photos	Foton
am	är
beginning	början
kindly	vänligt
boat	båt
small	små
siena	siena
lovely	härlig
part	del
conditioning	konditionering
tanning	garvning
advertised	annonserade
lanxess	lanxess
gym	Gym
world	värld
swans	swans
finish	Avsluta
mood	humör
studio	studio
amsterdam	amsterdam
double	dubbel
reccomend	reccomend
â	â € œ
thank	tacka
400	400
use	använda sig av
inner	inre
students	studenter
needs	behov
rest	resten
dana	dana
reason	anledning
quite	ganska
over	över
entertaintments	entutomat
travellers	resenärer
choose	välja
age	ålder
access	tillgång
therefore	därför
18th	18: e
spotlessly	spotlessly
major	större
croissants	croissanter
staff	personal
â·	·
nevskii	nevskii
no	Nej
surroundings	miljö
arrived	anlände
faded	urblekt
don	don
repeat	upprepa
guest	gäst
hand	hand
cheap	billig
childrens	barns
reply	svar
paris	paris
big	stor
chef	kock
shabby	sjaskig
heated	uppvärmd
stay	stanna kvar
acoustic	akustisk
literally	bokstavligen
code	koda
location	plats
dream	dröm
rubber	sudd
importen	importerande
order	beställa
wife	fru
forward	fram-
current	nuvarande
hard	hård
dj	dj
poor	fattig
really	verkligen
discounts	rabatt
3am	allmän
elevators	hissar
recomended	rekommendera
huge	enorm
enmenons	Enmenons
paper	papper
size	storlek
ask	fråga
maximizes	maximerar
tiling	kakel
fingerprints	fingeravtryck
damaged	skadad
alphons	alfons
chldren	barn
extrasthe	Extasthe
adequate	lämplig
realy	verklig
pm	pm
finding	fynd
heating	uppvärmning
experienced	erfaren
kitchen	kök
partner	partner
me	mig
hole	hål
camp	läger
greets	hälsningar
excelent	utmärkt
mgmt	mgmt
behind	Bakom
flower	blomma
expense	bekostnad
best	bäst
death	död
udaivilas	Udaivilas
pants	byxor
amazing	Fantastisk
helpfulathe	hjälpmedel
favorite	favorit-
paths	vägar
perfect	perfekt
leaking	läckande
have	ha
sunbeds	solstolar
dec	dec
aren	aren
connected	ansluten
madrid	madrid
zone	zon
machine	maskin
nl	nl
pillows	kuddar
sure	Säker
cleaning	rengöring
calm	lugna
sports	sporter
centrally	centralt
relaxatio	avslappning
refurnished	omvandlad
made	gjord
else	annan
insulation	isolering
cigarette	cigarett
2012	2012
breathtaking	hisnande
italien	Italien
areas	områden
tasty	gott
twice	dubbelt
making	tillverkning
unacceptable	oacceptabel
television	tv
super	super
con	med
dead	död
seen	sett
anymore	längre
service	service
seems	verkar
back	tillbaka
got	gok
singles	singel
knowledgeable	kunnig
doesen	göra
dutch	holländska
as	som
worth	värde
travelled	reste
requested	begärda
not	inte
grandaughter	gränslugn
hotels	Hotell
old	gammal
rer	rusa
rear	bak-
km	kilometer
meny	meny
attentive	uppmärksam
live	leva
angry	arg
bedroom	sovrum
axaha	elb
priced	prissatt
sauna	bastu
distances	avstånd
except	bortsett från
other	Övrig
stupid	dum
insects	insekter
need	behöver
m	m
numerous	talrik
funiture	möbel
fantastic	fantastisk
35	35
family	familj
fi	vara
shops	butiker
deventer	Deventer
spirits	sprit
jean	jean
professionell	professionell
dolphin	delfin
offered	erbjudande
walked	promenerade
surprise	överraskning
passed	passerade
continue	Fortsätta
choice	val
nearly	nästan
claiming	hävdande
guests	gäster
park	parkera
wilderness	vildmark
maintained	bibehållen
key	nyckel-
powerful	kraftfull
elina	elina
allocated	allokerad
under	under
looking	utseende
rail	järnväg
blocks	block
situated	belägen
pleasant	trevlig
neightborhood	grannskap
centre	Centrum
cracked	knäckt
restourant	restaurang
territory	territorium
needed	behövs
personal	personlig
train	tåg
inclusive	inkludera
frills	krusiduller
convention	konvent
didn	didn
luxury	lyx
dvd	dvd
surprised	överraskad
160	160
based	baserad
smallest	minsta
aldo	aldo
therethank	ThereNthank
elegance	elegans
try	Prova
liquires	sprit
couldn	kunde inte
nearby	närliggande
taken	tagen
slow	långsam
bigger	större
worn	bärs
willing	villig
defiantly	troligt
cloth	trasa
grey	grå
public	offentlig
opera	opera
friendliness	vänlighet
began	började
broken	bruten
ride	rida
things	saker
police	polis
almost	nästan
self	själv
linen	Linné
der	de
professional	professionell
set	uppsättning
dust	damm
once	en gång
player	spelare
bring	föra
beware	akta sig
ât	â € ™ t
scale	skala
trained	tränad
liked	gillade
reality	verklighet
both	både
lock	låsa
especially	framförallt
february	februari
legs	ben
pathã©	Pathé
ideally	idealiskt
uncomfortable	obekväm
complaints	klagomål
tower	torn
scrambled	krypterad
bad	dålig
fish	fisk
50	50
instead	istället
happened	hände
bathrooms	badrum
greek	grekisk
welcomes	välkomnar
website	hemsida
cleaned	rengöras
across	tvärs över
claustrophobic	klaustrofobisk
cocktails	cocktails
tried	försökte
amstel	amstel
champ	mästare
definitively	definitivt
sray	värdshus
15	15
euros	euro
gift	gåva
impressed	imponerad
closer	närmare
recommendable	rekommenderad
informed	informerad
time	tid
electrical	elektrisk
easy	lätt
singer	sångare
phone	telefon
lamps	lampor
humid	fuktig
owners	ägare
intersection	genomskärning
disappointed	besviken
th	th
even	även
chance	chans
respective	respektive
together	tillsammans
mostly	till största del
missed	missade
stuff	grejer
furnished	möblerad
through	genom
insisted	insisterad
also	också
espresso	espresso
duck	Anka
wait	vänta
rank	rang
cottage	stuga
fountain	fontän
south	söder
hamburger	hamburgare
revisiting	omvandling
myself	jag själv
scam	lurendrejeri
subway	tunnelbana
preciseness	förutsättning
transfer	överföra
campsite	campingplats
weekend	helgen
cannot	kan inte
personally	personligen
transport	transport
canine	hund-
beaches	stränder
washbasin	tvättställ
makes	gör
deter	avskräcka
girls	flickvän
less	mindre
hotel	hotell
meet	träffa
simple	enkel
near	nära
empty	tömma
between	mellan
building	byggnad
disadvantages	nackdel
prompt	prompt
mall	köpcenter
beer	öl
builnding	byggnad
video	video-
prepared	beredd
og	och
nevertheless	ändå
conditions	betingelser
requests	förfrågningar
disclose	avslöja
starting	startande
ready	redo
italian	italiensk
light	ljus
remark	anmärkning
visible	synlig
track	Spår
cycling	cykling
varieous	variös
cant	kan inte
topaz	topas
neatly	ordentligt
pizza	pizza
anna	anna
outside	utanför
directions	anvisningar
till	till
yourself	själv
good	Bra
storage	lagring
lounge	vardagsrum
allows	tillåter
smoking	rökning
finishes	slut
grand	stor
stations	stationer
businesstrips	affärsresa
gran	bra
exceptional	exceptionell
deal	handla
bedding	strö
prado	prado
seine	hans
liable	ansvarig
served	serveras
extra	extra
totally	totalt
smooth	slät
bugs	buggar
tele	tele
show	visa
niuewstraat	Niuuewstraat
alternation	alternering
providing	tillhandahålla
life	liv
towels	handdukar
assoiated	associerad
disclosed	avslöjad
redeeming	inlösande
everywhere	överallt
bath	bad
trying	påfrestande
ultra	ultra
comforts	bekvämlighet
massive	massiv
missing	saknas
relax	koppla av
tended	tenderade
confortable	bekväm
extreme	extrem
amel	handling
pleasure	nöje
aerea	antenn
cafe	Kafé
expectations	förväntningar
everyday	varje dag
nadia	nadia
miss	Fröken
cooks	kock
attractions	Sevärdheter
a	a
fitnes	kondition
languages	språk
delicious	utsökt
thoroughfare	genomfart
degrees	grader
bit	bit
cruise	kryssning
low	låg
stuck	fastnat
exposed	utsatt
nicest	finaste
international	internationell
sea	hav
express	uttrycka
booking	bokning
mistakes	misstag
mobile	mobil
delighed	lyft
improvement	förbättring
pleases	glädjes
climbing	klättrande
sastisfied	nöjd
loved	älskade
d	d
faulty	felaktig
ever	någonsin
pretty	Söt
stops	stannar
leaving	lämna
giant	jätte
impressions	intryck
disadvantage	nackdel
complaint	klagomål
right	höger
always	alltid
altstadt	altstadt
steakhouse	Steak House
able	kunna
confusing	förvirrande
outlet	utlopp
certainly	säkert
mohamed	Muhammed
suprised	överraskad
staircase	trappa
foor	foor
several	flera
holiday	Semester
became	blev
versa	versa
computers	dator
276	276
think	tror
floors	golv
satisfied	nöjd
appreciate	uppskatta
course	kurs
attended	deltog
flies	flugor
boy	pojke
dreamy	drömmande
grounds	grunder
peaceful	fredlig
robbed	rånade
allowing	tillåta
ð¢his	ð ¢ hans
smiles	ler
proffesional	professionell
information	information
24	24
they	de
takes	tar
carte	kort
program	program
only	endast
aquagym	akvagym
amination	amination
detail	detalj
candy	godis
of	av
generous	generös
colleagues	kollegor
travelodges	travelodges
elevator	hiss
slippers	tofflor
hear	höra
to	till
recomend	rekommendera
enjoyable	trevlig
renovarted	Renovorted.
advise	ge råd
recommendation	rekommendation
helped	hjälpte
careful	försiktig
morning	morgon-
though	fastän
dogs	hundar
infrastructure	infrastruktur
unhappy	olycklig
summer	sommar
enough	tillräckligt
responsibility	ansvar
chose	vald
oterwise	annat
step	steg
an	en
2013	2013
ideal	idealisk
came	kom
shoping	butik
example	exempel
triump	triumf
avoid	undvika
advantage	fördel
hussein	hussein
groups	grupp
return	lämna tillbaka
felt	känt
find	hitta
german	tysk
afew	några
âm	â € ™ m
ther	där
fast	snabb
base	bas
san	sanning
possibility	möjlighet
minded	sinnad
prefer	föredra
interesting	intressant
christmas	jul
cheese	ost
older	äldre
dubai	dub
amasing	amasing
check	kolla upp
consider	överväga
ship	fartyg
purpose	syfte
1300	1300
dish	maträtt
happiness	lycka
received	mottagen
mins	mins
wonderfull	underbar
floods	översvämningar
stores	butiker
comprehensive	omfattande
working	arbetssätt
exercise	träning
pools	pooler
inclysive	inkludera
map	Karta
cozy	mysigt
sunrise	soluppgång
pintxos	pintxos
thessaloniki	thessaloniki
thanks	tack
enthusiastic	entusiastisk
immidiately	omedelbart
drain	dränera
balcony	balkong
charged	laddad
different	annorlunda
general	allmän
reach	nå
wonderfully	underbart
busy	upptagen
affordable	överkomligt
30	30
12	12
smelt	smälta
fridge	kylskåp
internet	internet
clean	rena
tide	tidvatten
everything	allt
competent	behörig
âd	â € ™ d
times	tider
cleanest	renaste
having	har
palazzo	palazzo
wear	ha på sig
ones	de
necessary	nödvändig
peoplethe	peoplethe
places	placera
thomsons	thomsons
massage	massage
midnight	midnatt
someone	någon
end	slutet
some	några
serious	allvarlig
sri	sri
paid	betalt
generally	allmänt
offers	erbjudanden
few	få
reservation	reservation
hour	timme
guys	killar
premises	lokal
thought	trodde
ã¡gent	Ombud
mamlouk	mamlouk
station	station
higher	högre
exchanging	utbyte
koln	koln
dirtyour	dutter
boutiques	boutiquer
architecture	arkitektur
thrown	kastad
75	75
problem	problem
surf	surfa
trees	träd
volvereta	Volverte
ms	Fröken
quick	snabbt
meal	måltid
his	hans
tha	jag ska
butt	stånga
repair	reparera
transition	övergång
300	300
getting	få
summary	sammanfattning
typical	typisk
found	hittades
day	dag
organised	organiserad
online	uppkopplad
â±	±
martha	martha
marseillan	marseillan
is	är
sheets	lakan
expect	förvänta
named	som heter
after	efter
tiny	mycket liten
better	bättre
hopping	hoppande
1	1
unique	unik
quickly	snabbt
due	på grund av
type	typ
products	Produkter
steam	ånga
3	3
ã	Ã-
oliver	oliv
trier	trier
range	räckvidd
helpfull	hjälpmedel
afraid	rädd
maximum	maximal
b	b
years	år
corner	hörn
splendid	utmärkt
function	fungera
however	dock
rock	sten
unfriendly	ovänlig
replinished	fylld
lanka	lanka
pricey	dyr
sunbed	solstol
conclusion	slutsats
whose	vars
jacuzzi	jacuzzi
nicely	fint
courses	kurser
shous	skor
wall	vägg
continental	kontinental
two	två
surprisingly	förvånande
office	kontor
wasnt	var inte
assist	hjälpa
hours	himmar
might	makt
feast	fest
brought	tog med
thing	sak
tub	badkar
marvellous	underbar
free	fri
management	förvaltning
credit	kreditera
talking	talande
pyramid	pyramid
25	25
absolute	absolut
walkways	gångbanor
getaway	flykt
beautifully	vackert
stares	stirrar
olive	oliv
france	frankrike
7th	Hydda
until	fram tills
fist	näve
place	plats
joy	glädje
moved	rörd
trailer	trailer
denmark	Danmark
those	de där
sã¶dermalm	södermalm
tp	tp
letdown	besvikelse
thoroughly	grundligt
reseption	reception
lyon	lyon
admire	beundra
quiet	tyst
great	bra
if	om
november	november
1mile	1mil
american	amerikansk
probably	förmodligen
3rds	3rds
plage	Strand
toiletries	toalettartiklar
manner	sätt
eurostars	eurostarer
easily	lätt
wireless	trådlös
darling	älskling
apart	isär
city	stad
twin	tvilling-
setting	miljö
gone	borta
supported	stödjande
weren	avdelning
blend	blandning
nothing	ingenting
without	utan
will	kommer
located	belägen
lagune	lagun
â	â € "
gare	station
word	ord
accustomed	van vid
seemed	verkade
creaky	creaky
possible	möjlig
vodka	vodka
gardens	trädgårdar
stains	fläck
moments	stunder
interestingin	Intresserad av
book	bok
fault	fel
verz	vers
residential	bostads-
dine	din
every	varje
rain	regn
travelers	resenärer
arc	båge
t	t
take	ta
par	genom
luxurious	lyxig
then	sedan
lousy	nedlusad
wish	önskar
aqua	aqua
staying	vistas
spiderweb	spindelnät
disgusting	äcklig
created	skapad
trimphe	triomphe
egg	ägg
turkey	Kalkon
jumeriah	jumeirah
pitch	tonhöjd
may	Maj
holidaymy	holiday
lift	hiss
en	i
center	Centrum
walls	väggar
many	många
pub	pub
here	här
destinations	destinationer
crowded	fullt med folk
cleaness	renlighet
biggest	största
friend	vän
night	natt
left	vänster
lunch	lunch
did	gjorde
chill	kyla
canal	kanal
torn	trasig
alive	Levande
village	by
miserable	eländig
windows	fönster
alone	ensam
dorint	dorint
keys	nycklar
especialy	framförallt
reached	nådde
wine	vin
district	distrikt
has	har
10	10
touristic	turist
site	webbplats
rate	Betygsätta
sofa	soffa
villa	villa
about	handla om
linens	linne
meetings	möten
pleasantly	angenämt
reserved	reserverad
business	företag
surprising	förvånande
burger	burger
there	där
normal	vanligt
children	barn
employees	anställda
cereal	flingor
replenished	fylld
in	i
lack	brist
nightclubs	nattklubbar
worries	bekymmer
terrific	fantastiskt
borring	BORRING.
but	men
swiming	simning
pitches	pitcher
maid	hembiträde
bloody	blodig
needwe	nödvita
radio	radio
13	13
mum	mamma
cook	laga mat
provided	försedd
pre	före
entertainment	underhållning
ration	ransonera
eyesi	Ögat av
bussiness	bussighet
minutes	minuter
twist	vrida
specially	speciellt
than	än
give	ge
delicacies	delikatesser
hof	hof
suggest	föreslå
germans	tyskar
rude	oförskämd
trash	skräp
addition	tillägg
invaded	invaderad
laughed	skrattad
diner	diner
attending	delaktighet
hell	Helvete
â´	Â '
climbs	klättra
makers	beslutsfattare
hip	höft
matter	materia
deskstop	skrivbord
snorkeling	snorkling
steigenburger	Steigenberger
ijust	jag bara
decorative	dekorativ
number	siffra
5days	5 dagar
had	hade
allwe	allt vi
maybe	kanske
deserts	öken
us	oss
urine	urin
âs	â € ™ s
poland	polen
covered	täckt
true	Sann
trip	resa
thursday	Torsdag
let	låta
trousers	byxor
welcomed	välkomnade
garden	trädgård
allow	tillåta
space	Plats
at	på
choices	val
stopped	stannade
la	de
halles	hallar
hearts	hjärtan
700	700
returning	återvändande
late	sent
enjoy	njut av
meals	måltider
hurghada	hurghada
active	aktiva
review	recension
taste	smak
absolutely	absolut
visiting	besöker
aerobic	aerob
fact	faktum
known	känd
clerk	kontorist
compared	jämfört med
rungis	rungis
tasteswe	tasteswe
dancers	dansare
tidy	städa
water	vatten
top	topp
bus	buss
unforgettable	oförglömlig
square	fyrkant
entertain	underhålla
non	icke
going	gående
men	män
actual	faktisk
london	london
hamam	bad
colors	färger
construction	konstruktion
warm	värma
steep	brant
including	Inklusive
resorts	resorts
restrooms	toalett
corridor	korridor
tuscan	toskansk
future	framtida
restaraunts	Restauranger
people	människor
eurostar	eurostar
thats	det är
speaks	talar
hi	Hej
attractive	attraktiv
inedible	oätlig
months	månader
requires	kräver
pluss	plus
animaters	animatörer
welsh	walesiska
spreads	sprider sig
louvre	louvre
extended	utökad
living	levande
regular	regelbunden
cleanliness	renlighet
price	pris
team	team
famous	känd
flamenco	flamenco
note	notera
columbus	columbus
schiphol	schiphol
1st	1: a
charm	charm
departure	avresa
eg	t.ex
unbelievable	otrolig
titanic	titan-
request	begäran
magical	magisk
breakfast	frukost
tennisfriends	tennisfriends
superfriendly	supervänlig
main	huvudsaklig
2011	2011
8th	8: e
convenience	bekvämlighet
etc	etc
six	sex
sheraton	sheraton
betting	vadhållning
rather	snarare
sit	sitta
wery	blotta
slendid	lutande
from	från
sleep	sömn
finished	färdiga
hosts	värdshus
private	privat
inspection	inspektion
painting	målning
load	ladda
chosen	valt
date	datum
romantic	romantisk
floor	golv
cuisine	kök
terrace	terrass
extremely	ytterst
attention	uppmärksamhet
foreign	utländsk
champs	champs
heard	hört
week	vecka
asked	frågade
wide	bred
largest	största
assorted	blandad
considering	med tanke på
kinds	sorters
chipped	flisad
spaces	mellanslag
minus	minus-
smelled	luktade
was	var
something	något
flight	flyg
room	rum
recommended	rekommenderad
opportunitys	möjligheter
change	förändra
century	århundrade
rambla	rambla
waiters	servitörer
speaking	tala
buses	bussar
money	pengar
local	lokal
mini	mini
pot	pott
breakfasts	frukost
girl	flicka
out	ut
compact	kompakt
reasonable	rimlig
name	namn
animations	animationer
ness	ness
reception	reception
begrudge	missunna
plenty	massor
offering	erbjudande
character	karaktär
impression	intryck
florence	florens
eat	äta
very	mycket
telling	talande
carparking	bilparkering
blue	blå
planning	planera
placed	placerad
gaps	lucka
keep	ha kvar
game	spel
throughout	genom hela
explain	förklara
russians	ryssar
deprived	berövad
streets	gator
visit	besök
shoes	skor
lots	mycket
likely	troligt
colorful	färgrik
food	mat
elegant	elegant
suit	kostym
were	var
highly	i hög grad
foods	livsmedel
olso	oslo
stained	färgad
variuos	olika
gave	gav
screen	skärm
flag	flagga
driving	körning
unclog	lindra
soon	snart
bubba	bubba
minibar	mini-bar
checked	kontrollerade
ignorant	okunnig
it	Det
plays	pjäser
okay	Okej
wifi	wifi
arrivals	ankomster
vieuz	vieux
land	landa
bar	bar
animation	animering
person	person
upgrade	uppgradering
sunny	solig
bonus	bonus
relatively	relativt
bed	säng
passport	pass
coming	kommande
disaster	katastrof
milk	mjölk
eur	euro
immediately	omedelbart
air	luft
restricted	begränsad
gets	får
within	inom
economically	ekonomiskt
menu	meny
cool	Häftigt
restaurants	Restauranger
forced	tvingade
helpful	hjälpsam
again	om igen
pension	pension
min	mig
prepare	förbereda
sell	sälja
piece	bit
chair	stol
ia	han
up	upp
why	Varför
immaculately	obefläckat
eran	var
off	av
york	york
marriott	marriott
dishes	maträtter
bliss	salighet
boring	tråkig
invited	inbjuden
westminster	westminster
respects	respekt
dusting	damning
hostel	vandrarhem
solved	löst
english	engelsk
40	40
appart	ifrån
mountain	fjäll
because	eftersom
notre	vår
nite	nit
cake	kaka
yoghurt	yoghurt
flughaven	Flygplats
awesome	grymt bra
given	given
handicapped	handikappade
you	du
heater	värmare
unmatched	oöverträffad
realised	realiserad
s	s
octoberfest	oktoberfest
noticed	lagt märke till
hospitality	gästfrihet
shopping	handla
redecorated	inredd
du	från
creative	kreativ
ample	riklig
anywhere	var som helst
took	tog
like	tycka om
adjacent	intilliggande
shop	affär
say	säga
connect	ansluta
checkin	checka in
rates	priser
manager	chef
most	mest
suprise	suprise
establishments	anläggningar
abundant	riklig
go	gå
diversity	mångfald
reliable	pålitlig
gladly	gärna
charming	charmig
issue	problem
shame	skam
for	för
average	genomsnitt
idea	aning
visits	besök
disappointing	besvikelse
hoped	hoppades
steak	biff
bacteria	bakterie
luxurous	lyxig
touchwith	Touchwith
tv	tv
mountains	berg
first	först
impossible	omöjlig
safe	säker
wg	i
run	springa
ingeniously	genialt
monmarte	montmartre
mention	nämna
rat	råtta
desert	öken-
cover	omslag
hope	hoppas
fit	passa
april	april
wi	Och
countryside	landsbygden
argue	argumentera
renovation	renovering
modern	modern
high	hög
10m2	10m2
everybody	alla
7	7
institute	inleda
amount	belopp
spend	spendera
improved	förbättrad
winter	vinter-
excusive	ursäkta
usually	vanligtvis
picky	petig
railway	järnväg
standards	normer
basin	handfat
breathtaken	hisnande
call	ringa upp
invite	inbjudan
facility	anläggningen
mould	forma
frienly	Vänlig
basically	i grund och botten
window	fönster
bathtub	badkar
fairly	ganska
exelent	excellent
duty	plikt
horrible	fruktansvärd
heavily	kraftigt
somewhere	någonstans
her	henne
baku	baku
stayed	stannade
favourite	favorit
toast	rostat bröd
cabinets	skåp
finest	finaste
ad	annons
know	känna till
one	ett
vacation	semester
junior	junior
elysees	elyse
short	kort
decided	bestämt
booked	bokas
putting	sätta
patient	patient
variety	mängd
attitudes	attityder
vips	vör
another	annan
teenagers	tonåringar
attitude	attityd
loveliest	lovlig
mail	post
entire	hel
buiseness	företag
charge	avgift
speak	tala
means	betyder att
procedures	förfaranden
hostess	värdinna
courteous	artig
lot	massa
month	månad
bright	ljus
we	vi
sensational	sensationell
collapses	faller ihop
tables	tabeller
second	andra
looks	utseende
line	linje
customers	kunder
timely	i god tid
peopel	människor
opinion	åsikt
haque	Haque
common	allmänning
stag	stag
diidn	vägran
portions	portioner
everyone	alla
bookingcom	bookingcom
desired	önskad
unexpected	oväntat
all	Allt
more	Mer
grill	grill
advantadge	fördel
look	se
environment	miljö
nightclub	nattklubb
their	deras
damage	skada
climb	klättra
antic	dåtid
feeling	känsla
considered	anses vara
rent	hyra
could	skulle kunna
ancient	gammal
orly	mantel
strongly	starkt
supburb	supburb
escalator	rulltrappa
receptionists	receptionister
described	beskrivs
usual	vanliga
roll	rulla
extremly	extremt
flat	platt
cuddle	omfamning
love	kärlek
which	som
14	14
via	via
smart	smart
frankfurtter	Frankfurter.
metro	metro
unconfortable	obekväm
connections	förbindelser
full	full
parking	parkering
young	ung
customer	kund
rimini	rimini
sun	Sol
bread	bröd
namely	nämligen
last	sista
restaurant	restaurang
competences	kompetens
who	vem
difficult	svår
accomodation	boxod
seeing	seende
care	vård
orders	order
odd	udda
casino	kasino
support	Stöd
nor	inte heller
eight	åtta
reviews	recensioner
highway	motorväg
yet	än
pass	passera
nn	nn
anyway	i alla fall
bathroom	badrum
milano	milano
luggage	bagage
lights	lampor
cuase	orsak
services	tjänster
sewage	avlopp
exceptionally	exceptionellt
buffet	buffé
flamingo	flamingo
dat	Som
spacy	spacy
hr	hr
flights	Flyg
couples	par
four	fyra
exceeded	överskridit
bathrobes	badrock
airport	flygplats
market	marknadsföra
hospitable	gästfri
roadside	vid vägkanten
families	familjer
crazily	grazily
backing	stöd
wheel	hjul
used	Begagnade
riverside	riverside
how	hur
while	medan
tea	te
actually	faktiskt
delightful	härlig
smokers	rökare
interested	intresserad
went	åkte
wellness	välbefinnande
large	stor
theres	theres
espaccely	espracty
shelf	hylla
incredible	otrolig
iron	järn
wanted	ville ha
ensures	ser till
nice	trevlig
friendy	vänlig
spaciousthe	rymd
dinner	middag
card	kort
educated	utbildad
isolation	isolering
items	objekt
traveling	reser
stationthe	station
bars	barer
sufficient	tillräcklig
possibilties	möjligheter
hade	hade
minuscule	mycket liten
knew	visste
level	nivå
e	e
cologne	köln
buy	köpa
curtains	gardiner
treatment	behandling
taught	lärde
possibly	eventuellt
tho	tho
by	förbi
prefect	prefekt
conveniently	bekvämt
2010	2010
package	paket
disabled	Inaktiverad
garage	garage
i	jag
goggle	goggle
leeds	leeds
way	sätt
miami	miami
exact	exakt
couple	par
varieties	olika sorter
channel	kanal
pity	medlidande
department	avdelning
warmly	varmt
taxi	taxi
cold	kall
ago	sedan
managed	lyckades
explore	utforska
downtown	stadens centrum
coktailsstaff	coktailsstaff
robe	morgonrock
utrecht	utrecht
atmosphere	atmosfär
cope	klara
tasteful	smakfull
interior	interiör
points	punkter
calimera	kalimera
balu	boll
reef	rev
cooking	matlagning
done	Gjort
see	ser
knowledge	kunskap
drink	dryck
pipes	rör
neighborhoods	stadsdelar
vehicles	fordon
decorated	dekorerad
visitor	besökare
street	gata
stylish	stilig
wil	vill
vip	vip
;	;
6	6
ok	ok
vice	vice
weeks	Veckor
activities	verksamhet
shower	dusch
renewed	förnyad
cleaners	rengöringsmedel
expensive	dyr
smiling	leende
scandic	scandic
inn	värdshus
holidays	högtider
cancelled	inställt
work	arbete
gobelins	gobeliner
holidys	högtider
organized	organiserad
views	åsikter
safety	säkerhet
supermarket	mataffär
dorm	studenthem
bulgaria	bulgarien
functional	funktionell
likewise	likaså
alley	gränd
stays	stannar
weather	väder
presented	presenterad
spa	spa
vineyards	vingårdar
believe	tro
happily	lyckligt
landscaped	anlagd
tag	märka
funny	rolig
passing	godkänd
doing	håller på med
8	8
where	var
receptionist	receptionist
personnel	personal
hot	varm
selection	urval
husband	Make
visitors	besökare
info	info
arrival	ankomst
mainly	huvudsakligen
pizzeria	pizzeria
side	sida
tallinn	tallinn
cause	orsak
conference	konferens
make	göra
seats	säten
feels	känner
meat	kött
incredibly	otroligt
barcelona	barcelona
heart	hjärta
stephanie	stephanie
condition	skick
evening	kväll
mixed	blandad
pay	betala
come	komma
weekday	veckodag
ervery	varje
stone	sten
egypt	egypten
kã¶ln	käln
accommodation	boende
neighbourhood	grannskap
akward	besvärlig.
rocko	rocko
90	90
star	stjärna
upper	övre
wouln	väv
mr	herr
since	eftersom
pompidou	pompidou
liverpool	liverpool
downstairs	nere
event	händelse
spot	fläck
handled	hanteras
fee	avgift
constantly	ständigt
various	olika
lake	sjö
swipe	hårt slag
wc	toalett
rose	reste sig
score	Göra
concerning	rörande
europe	Europa
kuku	nagel
stress	påfrestning
she	hon
nov	nov
pond	damm
genuine	äkta
system	systemet
leisure	fritid
on	på
own	egen
that	den där
class	klass
worst	värst
toilet	toalett
nationality	nationalitet
quit	sluta med
conected	ansluten
brits	briter
welcomewould	välkomnar
parts	delar
much	mycket
dame	dame
regard	betrakta
brocken	brocken
touring	touring
issues	problem
books	böcker
cultures	kulturer
mistake	misstag
shadows	skuggor
chears	Turces
forum	forum
moneyi	pengar
facilities	anläggningar
mess	röra
dance	dansa
aforesaid	ovannämnda
rum	rom
included	ingår
unlike	till skillnad från
luxuries	lyx
floaties	floaties
frankfurt	frankfurt
disco	disko
superb	utmärkt
separated	separerat
checking	kontroll
and	och
vivaldi	vivaldi
definitely	definitivt
july	juli
hall	hall
vast	omfattande
silent	tyst
below	Nedan
climation	klimat
them	dem
cost	kosta
luxuryfood	lyxfood
destroyed	förstörd
add	Lägg till
kids	barn
helping	portion
advance	förskott
de	från
bike	cykel
profession	yrke
choises	val
blonde	blond
louise	louise
started	satte igång
yard	gård
queue	kö
renovated	renoverad
vas	du
cinema	bio
travelodge	travelodge
unpleasantness	obehag
smile	leende
using	använder sig av
yes	ja
throw	kasta
just	bara
layout	layout
asian	asiatisk
inexpensive	billig
perfectly	perfekt
aside	åt sidan
beautiful	skön
weekenders	weekendare
rotten	rutten
when	när
waits	vänja
paied	paied
tuscany	tuscany
4	4
available	tillgängligt
touristy	turist
close	stänga
arena	arena
alanani	Play-knappen
so	så
refrigerator	kylskåp
connection	förbindelse
120	120
job	jobb
anything	något
nespresso	nespresso
skype	skype
amenities	bekvämligheter
restaurat	återställd
channels	kanaler
chairs	stolar
spakenburg	Spakenburg
speed	fart
bland	mild
boulevar	boulevar
thick	tjock
completed	avslutad
start	Start
clubs	klubbar
purposed	utlovat
immediate	omedelbar
paying	betalande
belongings	tillhörigheter
already	redan
bathing	badning
swimmingpools	simbassänger
changes	ändringar
charme	charm
oberoi	oberoi
certain	vissa
azerbaijan	Azerbajdzjan
travel	resa
bands	band
tournaments	turnering
dedicaced	tillägnande
black	svart
tend	tendera
ritz	ritz
minute	minut
steigenberger	steigenberger
tourists	turister
costlier	dyrkare
never	aldrig
golf	golf
held	hölls
get	skaffa sig
comfy	bekväm
enjoyed	åtnjöt
indeed	verkligen
overpriced	för dyrt
with	med
soap	tvål
smaller	mindre
year	år
holland	holland
value	värde
y	Y
servings	serveringar
verry	vred
chic	chic
carlton	carlton
structure	strukturera
stars	stjärna
five	fem
stop	sluta
warmbarman	varmbåge
serve	tjäna
roof	tak
organization	organisation
european	europeisk
paradise	paradis
housekeeping	hushållning
goes	gå
complain	klaga
stolen	stulna
comfortable	bekväm
minimal	minimal
confirmation	Bekräftelse
sky	himmel
arranged	ordnad
mean	betyda
during	under
recommend	rekommendera
unfortunately	tyvärr
awful	förfärlig
breaker	brytare
features	funktioner
simplistic	naiv
hotelmanager	hotell chef
enterainment	underhållning
least	minst
smell	lukt
loud	högt
trips	resor
friends	vänner
narrow	smal
my	min
luxor	luxor
apartment	lägenhet
new	ny
russian	rysk
brandy	brandy
feb	feb
ate	åt
each	varje
well	väl
attendance	närvaro
playground	lekplats
must	måste
polish	putsa
downside	nackdel
2nd	2: a
dirt	smuts
earth	jord
coach	tränare
provide	förse
underneath	undertill
would	skulle
pool	slå samman
rebuilding	ombyggnad
are	är
discovery	upptäckt
following	följande
shape	form
pluspoint	pluspoint
whole	hela
fun	roligt
same	samma
homeless	hemlös
sneaky	lömsk
plan	planen
music	musik
hence	därmed
amp	amp
comfort	bekvämlighet
spoilt	bortskämd
seven	sju
tell	säga
costs	kostar
similar	liknande
daytime	dagtid
observations	observationer
your	din
lighting	belysning
river	flod
workers	arbetare
design	design
inside	inuti
built	byggd
shuttle	buss
excecutive	verkställande
boys	Pojkar
little	liten
hang	hänga
cigarrum	cigarrum
quicker	snabbare
refund	återbetalning
taking	tar
whenever	närhelst
won	vann
definetely	definitivt
playing	spela
break	ha sönder
agia	agia
standard	standard-
persistent	beständig
husaband	Haven och.
can	burk
animators	animatörer
before	innan
closes	stängs
round	runda
such	sådan
dress	klänning
deira	deira
greatincredible	greatincredible
avoided	undvek
chaos	kaos
important	Viktig
proximity	anslutning
lord	herre
bikes	Cyklar
complex	komplex
perfume	parfym
waiter	servitör
directly	direkt
stunning	fantastisk
kettle	vattenkokare
far	långt
recommendations	rekommendationer
welcoming	välkomnande
travelling	reser
holes	hål
spending	utgifter
words	ord
case	fall
buildings	byggnader
somewhat	något
problems	problem
diffrent	diffrent
oversee	övervaka
underconstruction	under konstruktion
flavouring	smaksättning
suite	svit
kassandria	kassandria
foot	fot
â¬	â, ¬
middle	mitten
fine	bra
â	â € ™
build	bygga
negga	negga
surrounding	omgivande
seashore	kust
itself	sig
reservations	bokningar
into	in i
three	tre
rules	regler
country	Land
resort	tillflykt
ground	jord
comfortablelounge	comformableLounge
amp;	amp;
petros	petros
happy	Lycklig
swimmingpool	simbassäng
relaxing	avkopplande
periferique	periferi
builders	byggare
highlights	belysning
help	hjälp
restful	rogivande
swimming	simning
elderly	äldre
or	eller
sound	ljud
town	stad
options	alternativ
beach	strand
visited	besökta
car	bil
2014	2014
hilton	hilton
checkouts	kassa
underground	underjordiska
provides	föreskriva
signal	signal
haven	hamn
c	c
overal	överallt
point	punkt
walking	gående
highways	motorvägar
jaccuzzi	jacuzzi
anyone	någon
woerden	woerden
drinks	dricker
spoiled	bortskämd
fabulous	fantastisk
remind	påminna
adjusted	justerad
elysee	elysee
cared	omhändertagen
destination	destination
experience	erfarenhet
intrusive	påträngande
firenze	Florens
smoked	rökt
worse	värre
dislike	motvilja
home	Hem
the	de
dansing	dans
convenient	bekväm
real	verklig
still	fortfarande
hundred	hundra
contemporary	samtida
offer	erbjudande
trams	spårvagn
relations	förbindelser
royalty	royalty
among	bland
yaer	Vem
table	tabell
castelo	Slott
gorgeous	underbar
furniture	möbel
honor	ära
tee	tee
heaven	himmel
reasons	skäl
friendly	vänlig
acceptable	godtagbar
ve	och
daily	dagligen
around	runt omkring
restored	återställd
smelly	stinkande
earned	tjänade
pirates	pirater
surely	säkert
style	stil
euro	euro
distance	distans
situation	situation
budget	budget
smsevery	smsvery
technology	teknologi
fresh	färsk
tasted	smakade
cusines	Kök
mexican	mexikansk
dining	matsal
polite	artig
area	område
next	Nästa
carpet	matta
30th	30: e
equipment	Utrustning
open	öppen
option	alternativ
negative	negativ
foyer	foajer
above	ovan
5	5
troubles	bekymmer
picturesque	pittoresk
door	dörr
staffs	personal
ibis	ibis
70s	70 x
comparing	jämförande
laying	läggning
dam	damm
pubs	pubar
rooms	rum
unclear	oklar
interest	intressera
decoration	dekoration
unless	såvida inte
partying	fester
said	sagt
print	skriva ut
outdated	föråldrad
swim	simma
jammed	fastna
remember	kom ihåg
cottages	stugor
ours	vår
beds	sängar
mother	mor
fashioned	utformad
be	vara
vacationpickalbatros	VacationPickalbatros
met	träffade
days	dag
miro	miro
feature	funktion
completely	fullständigt
normally	i vanliga fall
quality	kvalitet
persons	personer
cross	korsa
state	stat
pleaseure	nöje
freezing	frysning
march	Mars
di	från
overall	övergripande
glad	glad
moquette	matta
afterwards	efteråt
n	n
siro	siro
port	hamn
montjuic	montjuisk
save	spara
straight	hetero
originally	ursprungligen
pantaneto	Putaneto
registration	registrering
early	tidigt
dated	daterad
streetside	streetside
modest	blygsam
executive	verkställande
excursions	utflykter
oriental	orientalisk
honeymooners	smekmånad
brussels	brussels
lifestyle	livsstil
view	se
what	Vad
its	dess
lost	förlorat
20	20
9	9
forthcoming	tillmötesgående
vitosha	vitosha
too	för
designed	designad
surge	svalla
spacious	rymlig
hte	hte
relaxed	avslappnad
leave	lämna
worked	arbetade
our	vår
juices	juice
please	snälla du
handle	hantera
per	per
wasn	var
period	period
bother	besvära sig
delivery	leverans
talk	prata
wooden	trä-
sorted	sorterad
idem	det samma
snorkelling	snorkling
audience	publik
noticeable	märkbar
timing	tidpunkt
members	medlemmar
plus	plus
kind	snäll
accompanied	åtföljd
concept	begrepp
trouble	problem
recently	nyligen
although	fastän
welcome	Välkommen
he	han
nord	Norr
adult	vuxen
brilliant	lysande
fat	fett
son	son
efficiently	effektivt
practically	praktiskt taget
steps	steg
length	längd
higly	hiktigt
etiquette	etikett
efficient	effektiv
read	läsa
tram	spårvagn
despite	trots
adults	vuxna
feel	känna
emily	emily
bilbao	bilbao
possitive	positiv
dirty	smutsig
road	väg
mice	möss
complained	klagade
residents	invånare
secure	säkra
meters	meter
montmartre	montmartre
noisy	högljudd
varied	varierande
safisfied	nöjd
tourist	turist
running	löpning
cars	bilar
commonly	vanligen
entrance	ingång
frequent	frekvent
hermitage	hermitage
excellent	excellent
enter	stiga på
correspond	motsvara
behold	skåda
weekly	varje vecka
usd	USD
seaside	kust
central	central
otherwise	annat
simply	helt enkelt
games	spel
crazy	galen
club	klubb
sasha	sasha
any	några
kallithea	Kallithea
ihad	önskvärd
house	hus
bass	bas
apartments	lägenheter
kindness	vänlighet
thinks	tänka
re	re
gold	guld-
mangers	mangor
strip	remsa
perfekt	Perfekt
treated	behandlad
messe	messe
equipped	utrustad
calling	kallelse
disappointment	besvikelse
outstanding	utestående
noice	noice
marinachania	marina
tastes	smak
association	förening
gilde	gille
2	2
saff	lager
desk	skrivbord
terrible	fruktansvärd
sharm	sharm
breaks	bryta
palace	palats
down	ner
sablon	Skärmavbildning
fantastically	fantastiskt
this	detta
alright	OK
fully	fullt
noise	ljud
whisky	whisky
tip	dricks
looked	tittade
mega	mega
copenhagen	köpenhamn
scenic	naturskön
backpackers	backpackers
match	match
recent	nyligen
george	george
these	dessa
front	främre
spoken	talad
classiest	klasigaste
fitness	kondition
manicured	manicured
casa	Hus
wonderful	underbar
thus	Således
plaesantly	plaesly
maker	tillverkare
walk	promenad
want	vilja
do	do
being	varelse
melia	melia
away	bort
jam	sylt
egypts	Egyptis
locate	lokalisera
french	franska
