creative	ijodiy
once	bir marta
summary	qisqacha ma'lumot
institute	institut
confortable	qulay
young	yosh
welcomewould	kutib olmoq
400	400
rer	shoshqaloqlik
did	qildi
dead	o'lik
many	ko'p
talk	bahslashmoq
electrical	elektr
real	haqiqiy
working	ishlamoq
parking	to'xtash joyi
biggest	eng katta
animation	animatsiya
wery	pardali
review	ko'rib chiqmoq
which	qaysi
hospitality	mehmondo'stlik
chance	imkoniyat
kuku	tirnoq
enthusiastic	g'ayratli
hardly	qiyin
hip	xip
sorted	tartiblangan
cabinets	kabinet
why	nima uchun
executive	ijro etuvchi
is	bu
tables	Jadvallar
stylish	zamonaviy
6	6
furniture	mebel
sneaky	horg'in
reachable	erishib bo'ladigan
superfriendly	juda qiziquvchan
gave	berildi
heart	yurak
crazy	aqldan ozgan
40	40
shelf	raf
date	sana
wasn	isyonchi
client	mijoz
upgrades	Yangilanishlar
queue	navbat
done	bajarildi
cruise	kruiz
udaivilas	Udadiras
tennisfriends	tennofiztriendy
underconstruction	qurilish ishlari olib borilmoqda
4years	4 yosh
improvement	yaxshilash
distances	masofa
of	dan
en	ichida
conference	konferensiya
ultra	ultra
queries	savol bermoq
smooth	silliq
pasta	makaron
overworked	ortiqcha ishlagan
between	orasida
miss	sog'inmoq
spirits	ruhlar
speaking	Gapirmoqda
mangers	mangerlar
left	chapda
several	bir nechta
picky	qadoqlamoq
2010	2010 yil
interior	ichki
super	super
transfer	o'tkazmoq
tide	to'lqin
foreign	xorijiy
visitors	tashrif buyuruvchilar
paying	to'lov
ã¢ââ	Ã â € "Oâ €"
would	bo'lardi
85	85
bland	g'alla
inn	karvonsaroy
sky	osmon
photos	Rasmlar
more	Ko'proq
restaraunts	restoranlar
orders	buyruqlar
downside	salbiy
department	Bo'lim
leeds	lazzat
nespresso	nespresso
tulip	lola
10	10
lake	ko'l
nationality	millat
grandaughter	nesup
server	server
gare	stantsiya
bugs	xato
peaceful	tinch
directions	yo'nalish
2011	2011 yil
impressive	ta'sirli
state	davlat
yaer	JSSV
eat	yemoq
stayed	qolgan
luxuryfood	hashamatfud
corner	burchak
lack	yo'q bo'lmoq
again	yana
forced	majburiy
luggage	bagaj
boat	qayiq
s	s
servings	xizmat
meters	metr
level	Daraja
programme	dastur
milad	tug'ilgan kun
byron	bo'ron
march	mart oyi
trained	o'rgatilgan
elderly	keksa
darling	daryo
called	chaqqon
supermarket	Supermarket
far	uzoq
sufficient	yetarli
inner	ichki
glasses	ko'zoynak
worth	arziydigan
sure	ishonch hosil qilmoq
chears	Uncha
newspaper	gazeta
april	aprel
especialy	ayniqsa
aldo	aldo
ship	kema
sports	sport
strongly	kuchli
disappointment	umidsizlik
so	shunday qilib
gobelins	gobelins
rent	ijara
weeks	haftalar
amination	achinish
been	bo'lgan
nights	tunlar
pintxos	pinteros
open	ochiq
seemed	tuyuldi
unexpected	kutilmagan
enterainment	o'yin-kulgi
relaxatio	yengillik
bit	bit
base	asos
brought	olib keldi
ã¢ââ	Ã â € â € ™ â € ™ â €
arrival	kelish
forks	archa
torn	yirtilgan
tourists	Sayyohlar
bur	burishmoq
facilities	Muvofiqliklar
options	Variantlar
l	l
cancelled	bekor qilindi
finding	topish
relations	munosabatlar
liverpool	"Liverpul"
grounds	asoslar
greatincredible	ajoyib
unless	bo'lmasa
because	chunki
perfectly	Mukammal
disabled	nogiron
nite	urish
ignorant	johil
suppose	o'ylamoq
swim	suzmoq
drain	drenajlamoq
4	4
hungry	och
six	olti
hair	Soch
friend	do'st
match	o'yin
consider	o'ylab ko'ring
fortunately	xayriyat
smoke	tutun
cover	qopqoq
soon	tez orada
nes	kabi
cuddle	quchoqlamoq
germans	Nemislar
possible	mumkin
sun	quyosh
care	g'amxo'rlik
traveling	sayohat
place	joy
enough	yetarli
village	qishloq
d	dum
they	ular
twin	egizak
niuewstraat	Niuuanstrat
thinks	deb o'ylaydi
vast	ulkan
reservation	bron qilish
fitnes	fitness
stairs	zinapoya
laying	yotqizish
look	qarash
ia	u
sercices	Xizmatlar
swans	oqshom
splendid	juda yaxshi
grubby	grubbi
afraid	qo'rqitmoq
honest	rostgo'y
cook	pishirmoq
amazing	ajoyib
excusive	izni ko'rsatadigan
noisy	shovqinli
immediately	darhol
ã¢â±	Ã Â Â Â Â Â
transport	transport
holes	teshiklari
weren	palata
vegetarian	vegetarian
changes	o'zgarishlar
boutiques	butiklar
radio	radio
books	Kitoblar
trimphe	TRIOMMPE
else	boshqa
renovation	ta'mirlash
massive	katta
friendy	zolim
being	bo'lish
packing	Qadoqlash
delighed	Men maftunman
ã¢ââll	Ã â € â € ™ ll
reviews	Sharhlar
lot	lot
swimmingpools	suzishpoollar
dream	orzu qilmoq
warmbarman	issiqxona
without	yo'q
countryside	Qishloq joy
amsterdam	amisterdam
certainly	albatta
field	maydon
smaller	kichikroq
overal	hamma joyda
france	Frantsiya
finish	tugatmoq
ritz	ritz
lift	ko'tarmoq
og	va
recommend	tavsiya qilmoq
shape	shakl
beds	to'shak
statements	bayonotlar
literally	tom ma'noda
studio	studiya
residents	aholisi
canine	kanin
san	sanmoq
cool	salqin
unacceptable	qabul qilib bo'lmaydigan
make	qilmoq
impression	taassurot
house	uy
there	U yerda
one	biri
unmatched	tengsiz
skype	skayp
leisure	dam olish
incredibly	nihoyatda
;	;
deteriorating	yomonlashish
shoes	poyabzal
doesn	hech narsa
deskstop	ish stassi
board	kengash
exceptionally	juda
building	qurilish
repeatative	takroriy
death	o'lim
celebrations	tantanalar
girls	qizlar
door	eshik
wg	ichida
main	asosiy
apartment	kvartira
structure	tuzilish
add	qo'shmoq
vending	vizusi
rear	orqa
confusing	chalkash
under	ostida
machine	mashina
fantastically	g'aroyiblarcha
happily	baxtiyor
feels	his qilmoq
earned	maosh oladigan
toiletries	hojatxonalar
chairs	Kafedralar
issue	nashr
mess	tartibsizlik
gets	olis
smelled	hidlangan
idea	fikr
buildings	Binolar
allocated	ajratilgan
linen	zig'ir
gladly	mamnuniyat bilan
flights	Reyslar
educated	o'qigan
bars	barlar
read	o'qimoq
prepare	tayyorlamoq
jammed	pirog
dirt	axloqsizlik
stephanie	stefani
frankfurt	frankfurt
build	qurmoq
amount	miqdori
favourite	sevimli
pleasant	yoqimli
likewise	xuddi shunday
technology	texnologiya
ideal	ideal
shous	poyabzal
marriott	nikoh
reflected	aks ettirilgan
general	umumiy
dec	sekund
inedible	yeyilmaydigan
receptionist	qabulxona
example	misol
enjoy	zavqlanmoq
feyyoz	feyoz
probably	ehtimol
flughaven	Aeroport
thoroughly	sinchkovlik bilan
famous	mashhur
package	paket
summer	yoz
domicile	doimiy yashash
means	demak
aerobic	aerob
reception	ziyofat
columbus	kolumbus
dated	sanoqli
dress	kiyinish
oversee	nazorat qilmoq
relax	Rohatlaning
15	15
feature	o'ziga xos xususiyat
no	yo'q
18th	18-chi
eg	masalan
costs	xarajatlar
minimum	eng kam
childrens	bolalarga oid
square	kvadrat
decently	bemalol
foot	oyoq
attention	diqqat
deserts	cho'llar
realy	real
desserts	pishiriqlar
touristy	turistik
ã¢ââm	Ã ™ m â € ™ m
knowledgeable	bilimdon
manicured	manmig'i
renewed	yangilangan
perhaps	ehtimol
every	har bir
pitches	yig'moq
son	o'g'li
winter	qish
vips	VIP
walls	devorlar
giant	ulkan
2nd	2-chi
mistakes	Xatolar
classic	klassik
miro	miram
rebuilding	qayta qurish
terms	shartlar
blocks	bloklar
oasis	voha
seine	uning
flat	kvartira
7	7
charme	joziba
okay	xop
highly	juda
seats	O'rindiqlar
avoid	oldini olmoq
makes	qiladi
them	ularni
set	sozlamoq
lagune	la'nati
liked	yoqqan
outside	tashqi
expected	kutilgan
by	bilan
chose	tanlamoq
sastisfied	qanoatlantiradigan
solved	hal qilingan
across	bo'ylab
think	o'ylamoq
damaged	shikastlangan
terrace	teras
steigenburger	Steigenberger
impressed	ta'sirchan
delightful	zavqli
montmartre	monastir
weekday	Hafta kuni
table	stol
â´	oy
throw	otmoq
hbo	Xalal
scale	shkala
knew	biladigan
stopped	to'xtatildi
garage	garaj
mcdonalds	McDonalds
etc	va boshqalar
basin	havzasi
grill	gril
sunbeds	quyosh yostiqlari
assured	ishongan
worked	ishlagan
this	bu
appartement	kvartira
builders	quruvchilar
honeymooners	asalimlar
alwys	alpsys
finished	tugatilgan
white	oq
inexpensive	arzon
gift	sovg'a
wifi	Wi-fi
quite	juda
unfriendly	do'stona
recommended	tavsiya etilgan
poland	Polsha
repeated	takrorlangan
soft	yumshoq
climb	ko'tarilmoq
beaches	sohillar
thursday	Payshanba
gilde	gildiya
breathtaking	hayajon
garden	bog '
park	park
mice	sichqonlar
came	keldilar
milk	sut
applied	qo'llanilgan
climation	iqlimni iqtibos
stays	qoladi
sharm	sharm
missing	yo'qolgan
reccomend	bajarmoq
separated	ajratilgan
prepared	tayyorlangan
market	bozor
hotel	mehmonxona
polish	jilov
mamlouk	momluk
cake	tort
kindness	mehribonlik
spaciousthe	keng
english	inglizcha
friendly	do'stona
narrow	tor
transition	o'tish
costlier	lojeyer
chosen	tanlangan
strict	qattiq
menu	menyu
flies	pashshalar
bonus	bonus
opinion	fikr
fist	musht
concerning	bor
dubai	dubay
topaz	topaz
absolutely	mutlaqo
sasha	sasha
see	ko'rmoq
wireless	simsiz
excellent	juda yaxshi
brandy	brendi
toilet	hojatxona
disaster	tabiiy ofat
tornese	yirtiq
surge	ko'tarilish
available	mavjud
daily	har kuni
warmly	iliq
feel	his qilmoq
tray	patnis
degrees	dog '
wilderness	sahro
jean	shilmoq
necessary	zarur
paris	parij
adult	kattalar
varieties	navlari
advance	oldinga siljish
how	Qanaqasiga
animations	animatsiyalar
true	to'g'ri
â·	oril
con	bilan
dansing	raqsga tushish
rank	unvon
dana	Dana
child	bola
whisky	viski
generally	umuman
inclysive	inkuziyaga oid
dislike	yoqtirmaslik
refurnished	o'chirilgan
pizzeria	pitsia
ground	yer
6am	6AM
lost	yo'qolgan
petros	petros
competent	vakolatli
travelling	sayohat
should	kerak
space	kosmos
guess	taxmin qilmoq
completed	tugallangan
design	dizayn
powerful	kuchli
surf	shilmoq
limited	cheklangan
dat	Qaysi
tip	ris
collapses	qulaydi
dayfor	kun
empty	bo'sh
colleagues	hamkasblar
accommodating	yaqinda bo'ladigan
husband	er
change	o'zgarish
heavily	qattiq
nowadays	shu kunlarda
partying	parvarishlash
cross	kesib o'tish
game	o'yin
cusines	oshxonalar
what	nima
u	ichida
anyone	har kim
persistent	qat'iy
ð¢his	â €
rum	ROM
hilton	xilton
homeless	boshpanasiz
preciseness	aniqlik
mainly	asosan
refrigerator	muzlatgich
stable	barqaror
rules	qoidalar
hall	zal
ansd	ansd
travel	sayohat qilmoq
romantic	romantik
perfekt	Mukammal
joy	quvonch
purpose	maqsad
honor	sharaf
invited	taklif qilindi
everã½one	abadiy
features	Xususiyatlari
buses	Avtobuslar
km	km
philosophical	falsafiy
royal	qirollik
treatment	davolash
infrastructure	infratuzilma
as	kabi
suit	kostyum
bussiness	qayg'u
brilliant	yorqin
titanic	titanik
heated	qizdirilgan
cooking	pishirish
in	ichida
pitch	ohang
constantly	doimo
using	ishlatish
waiters	ofitsiantlar
conclusion	xulosa
experienced	tajribali
to	ga
better	yaxshiroq
royalty	royalti
ness	ness
peoplethe	do'plet
opportunitys	imkoniyatlar
below	quyida
appearances	Tashqi ko'rinishi
missed	o'tkazib yuborilgan
5days	5 kun
80	80
backpackers	xaltachalar
possibilties	imkoniyatlar
saw	arra
corridors	yo'lak
avoiding	oldini olish
europeans	Evropaliklar
manner	usul
rude	qo'pol
matress	zambil
2014	2014 yil
forum	forum
di	dan
nicely	yaxshi
continue	davom etmoq
matter	ahamiyat
welcomes	ma'qullamoq
crowded	gavjum
35	35
french	fransuz
customer	xaridor
europe	boshqa
90	90
restaurant	restoran
abundant	mo'l-ko'l
claustrophobic	klaustrofobik
very	juda
plenty	mo'l-ko'l
hoped	umid qilgan
slippers	shippak
restrooms	hojatxonalar
stolen	o'g'irlangan
carparking	avtomobil
hussein	Xusseyn
linens	choyshab
prefect	prefektura
dam	to'g'on
budget	byudjet
helpfulathe	yordam bermoq
goggle	ko'zga to'kmoq
nor	ham
speed	tezlik
american	amerikalik
noticeable	sezilarli
diversity	xilma-xillik
flamingo	flamingo
steep	tik
video	video
maybe	balki
whose	kimning
expect	kutmoq
snorkelling	snarkele
peopel	odamlar
humid	nam
oriental	sharqqa oid
rundown	bosib ketish
basically	asosan
shadows	soyalar
handicapped	nogiron
admire	qoyil qolmoq
crazily	badqovoq
district	tuman
who	JSSV
egyptian	misrlik
extensive	keng
facilties	Muvofiqliklar
italian	italyan
elegant	oqlangan
halles	zallar
166	166
bubba	bubba
help	Yordam bering
channel	kanal
control	boshqaruv
tiny	mayda
event	voqea
remark	izoh
8th	8
litle	liq
arena	arena
meetings	Uchrashuvlar
meet	uchrashmoq
disappointing	umidsizlik
travelodges	sayohatchi
stress	stress
thick	qalin
side	tomon
slendid	qarich
already	allaqachon
siro	sero
stops	to'xtaydi
defiantly	muqarrar
neither	ham
credit	kredit
welsh	uelsh
tasteful	mazali
restaurants	restoranlar
diidn	voz kechish
ijust	Men faqat
cakes	kek
unbelievable	ishonib bo'lmaydigan
mould	mog'or
barcelona	"Barselona"
dedicaced	bag'ishlanish
jaccuzzi	jakaluzzi
clubs	Klublar
gemma	gemma
gaps	bo'shliq
replinished	to'ldirilgan
info	ma'lumot
tube	nayza
eastern	sharqiy
odd	g'alati
luxor	lug'ak
underneath	ostidan
co	ko
comfort	qulaylik
had	bor edi
knowledge	bilim
ibis	ibis
courses	kurslar
comfy	komil
destroyed	vayron bo'lgan
staffs	Xodimlar
music	musiqa
discounts	Chegirmalar
managers	menejerlar
makers	ishlab chiqaruvchilar
buffet	bufet
program	dastur
location	Manzil
correspond	mos keladi
have	bor
builnding	qurilish
smokers	chekuvchilar
making	tayyorlash
next	Keyingi
neatly	to'g'ri
dutch	golland
recommendation	tavsiyanoma
perfume	atir
âd	â € ™ d
recommending	tavsiya etish
unpleasant	yoqimsiz
aren	aren
but	lekin
rambla	ramz
hen	juda
catered	ranjir
sadly	afsuski
moneyi	pul
maid	xizmatkor
grand	katta
home	uy
police	politsiya
addition	qo'shimcha
various	har xil
single	yolg'iz
services	Xizmatlar
exhibition	ko'rgazma
avoided	qochib qolgan
little	oz
rocko	roko
smiles	jilmaymoq
fingerprints	barmoq izlari
laughed	kuldi
snacks	atıştırmalıklar
definitively	aniq
assist	yordam bermoq
overcrowd	haddan tashqari
properly	to'g'ri
miserable	baxtsiz
holland	golland
provide	ta'minlamoq
sleep	uyqu
tele	tele
ã°â¢his	Â ¢
satisfied	qanoatlantiradigan
chef	oshpaz
poor	kambag'al
held	boshlang'ich
golf	golf
got	oldim
hysterical	hasratli
exceptional	bejirim
mountains	tog'lar
pathã£â©	PAVO £ ©
tallinn	uzun bo'yli
ã	"
insects	hasharotlar
such	shunday
hence	shu sababli
lovely	yoqimli
shoping	do'kon
tanning	xunuk
nord	Shimoliy
asian	Osiyo
invaded	bosqinchi
the	bu
cozy	shinam
vip	vIP
firenze	Florensiya
elevators	lift
recomend	qayta taklif qilmoq
elevator	lift
took	olib bordi
sunbed	quyosh bilan
informing	xabardor
opted	taniqli
track	yo'llamoq
bedroom	yotoqxona
fall	yiqilmoq
personnel	xodimlar
wouln	fohisha
conveniently	qulay tarzda
silent	jim
buy	sotib olmoq
ash	kul
refund	qaytarmoq
informed	xabardor
check	tekshirmoq
superb	superb
steam	bug '
beaituful	Chiroyli
certain	ma'lum
complain	shikoyat qilmoq
underwhelmed	betartib qolgan
own	Shaxsiy
surprising	hayratlanarli
from	dan
guys	Yigitlar
spakenburg	Speketka
comfortable	qulay
always	har doim
normal	normal
opera	opera
sell	sotmoq
closer	yaqinroq
holiday	bayram
curtains	pardalar
requires	talab qilmoq
code	kod
notre	bizning
possibility	imkoniyat
sauna	saun
than	dan
nov	nova
carte	kartochka
noise	shovqin
120	120
norwiegen	nora
insisted	talab qilib qo'ygan
recent	yaqinda bo'ladigan
breathtaken	nafas olayotgan
generous	saxiy
sandwiches	sandal
went	bormoq
central	markaziy
appreciate	qadrlamoq
my	mening
hope	umid qilmoq
remind	eslatmoq
milano	milan
known	ma'lum
egg	tuxum
daytime	kunduzgi
together	birga
indeed	haqiqatdan ham
fish	baliq
try	sinab ko'rmoq
year	yil
bed	to'shak
accompanied	hamroh bo'ladigan
hotels	mehmonxonalar
waits	kutadi
spent	sarflangan
vacation	ta'til
trips	sayohatlar
website	veb-sayt
access	kirish
cloth	mato
completely	butunlay
office	idora
that	bu
stares	tikuv
run	yugurish
effort	harakat
hole	teshik
businesstrips	ishbilarmon
believe	ishonmoq
priced	narx
terrific	dahshatli
premises	bino
arrived	yetib keldi
railway	temir yo'l
saff	qatlam
â¬	Xo'sh
faulty	noto'g'ri
incl	shu bilan birga
views	Ko'rishlar
procedure	tartib
included	kiritilgan
situated	joylashtirilgan
glad	xursand
any	har qanday
provides	ta'minlaydi
know	bilmoq
flamenco	flamenko
playground	o'yin maydonchasi
appeared	paydo bo'ldi
immaculately	beadab
he	u
despite	qaramay
luxurous	hashamatli
hang	osmoq
pointed	ishora
mina	meniki
restourant	restoran
schiphol	shipol
come	keling
foor	fohisha
warm	iliq
distance	masofa
t	t
helping	yordam berish
built	qurilgan
highways	Magistral yo'llar
management	boshqaruv
300	300
accomodation	biror narsa
tho	qayramoq
you	siz
magical	sehrli
anybody	hech kim
station	stantsiya
alone	yolg'iz
won	yutuq
christmas	rojdestvo
bloody	qonli
via	orqali
exceptions	Istisnolar
happy	baxtli
long	uzoq
ingredients	Tarkibi
everywhere	hamma joyda
larger	katta
registration	ro'yxatga olish
trying	harakat qilmoq
layover	burish
awesome	ajoyib
sodas	sodali
floors	qavatlar
7th	Kulba
or	yoki
outskirts	chekka
trousers	shim
issues	Muammolar
cereal	don
rimini	rimini
bright	yorqin
reserved	zahiralangan
hurghada	badbashara
prado	pramand
cigarrum	tirgak
sea	dengiz
cope	dog '
candy	shirinlik
frankfurtter	Frankfurter.
cathode	katod
named	nomlangan
lock	qulflamoq
scam	tovlamachilik
e	t
scandic	janjalkash
landscaped	dabdabali
yourself	o'zingiz
swift	tez
kettle	chovgum
procedures	tartibsizlik
diabolical	iblisona
buiseness	biznes
minuscule	kinuskus
earth	er
feast	to'y
checkouts	Cheklovlar
fun	kulgili
about	haqida
smelly	hidi
elina	podsho
selected	tanlangan
cinema	kinoteatr
accommodation	turar joy
bigger	katta
dull	zerikarli
nn	nn
time	vaqt
right	to'g'ri
large	katta
tv	televizor
rest	dam olish
exact	aniq
sablon	Ekranni bosib chiqarish
visitor	Mehmon
maintained	davom ettirildi
fat	yog '
normally	normal holatda
money	pul
attrackts	atoqqa atash
frills	chilli
south	janub
calimera	kalimera
for	uchun
practical	amaliy
similar	o'xshash
specific	o'ziga xos
received	qabul qildi
words	so'zlar
kept	saqlanib qolgan
trees	Daraxtlar
checkout	tekshirib ko'rmoq
future	kelajak
higly	higel
failing	muvaffaqiyatsiz
1300	1300
audience	tomoshabinlar
goodthe	Yaxshi
dark	qorong'i
booked	bron qilingan
downstairs	pastga
layout	tartib
spacy	boshliq
lots	juda ko'p
choices	Tanlovlar
grey	kulrang
wait	Kutmoq
use	foydalanish
flower	gul
bathing	cho'milish
responsibility	javobgarlik
connection	ulanish
speak	gapirmoq
described	ta'riflangan
conditions	shartlar
cereals	don
plaesantly	ancha
learn	o'rganmoq
collected	yig'ilgan
sewage	kanalizatsiya
equipment	asbob-uskunalar
score	Hisob
accustomed	odatlangan
unconfortable	noqulay
favorite	sevimli
repetitive	takroriy
goes	ketadigan
five	besh
love	muhabbat
stationthe	sayyora
loveliest	yoqimli
dust	chang
houses	uylar
and	va
different	har xil
singles	yakka
otherwise	aks holda
letter	xat
burger	burger
port	portlamoq
luxury	hashamat
âs	bu
night	kechasi
y	Shilmoq
information	ma `lumot
calm	sokin
de	dan
decoration	bezatish
thing	narsa
easily	osonlikcha
sunrise	quyosh chiqishi
ones	bir kishi
common	umumiy
satisfaction	qoniqish
good	yaxshi
russian	rus
canal	kanal
tidy	toza
linked	bog'langan
spotlessly	ayyorlarcha
boys	o'g'il bolalar
wonderfully	ajoyib
smile	tabassum qilmoq
queens	kvins
slow	sekin
iron	temir
need	ehtiyoj
passport	pasport
focused	e'tibor qaratilgan
spaces	bo'shliqlar
convention	konventsiya
du	dan
koln	koln
disadvantages	Kamchiliklari
period	davr
thrown	tashlandi
chair	kafedra
everã£â½one	har doim latta
desert	cho'l
these	bular
camp	lager
anything	har qanday narsa
find	topmoq
welcoming	qutlamoq
mother	Ona
unpleasantness	ko'ngilsizlik
internal	ichki
save	tejash
simply	oddiy
restful	tinch
duty	burch
serious	jiddiy
centrally	markazda
parts	qismlar
advise	maslahat bermoq
euro	evro
swimmingpool	suzish xavzasi
both	ikkalasi ham
country	mamlakat
â	â € â €
possitive	iltifot
anymore	boshqa
all	hamma
lunch	tushlik
brocken	brokka
with	bilan
result	natija
charge	ayblamoq
immidiately	darhol
river	daryo
minute	minut
created	yaratilgan
doing	qil
chill	sovitmoq
difficult	qiyin
unclear	tushunarsiz
city	shahar
type	tur
thus	shunday qilib
charged	ayblangan
20	20
butt	dum
channels	kanallar
3	3
inclusive	inkuziyaga oid
taking	olmoq
housekeeping	uy bekasi
nadia	nadiya
old	eski
air	havo
maximizes	maksimal darajada oshiriladi
palazzo	palazzo
begrudge	baqa
streetside	izdosh
groups	guruhlar
phone	telefon
standard	standart
eurostars	Eurostarlar
delicacies	lazzatli
altstadt	altstadt
nearby	yaqinida
woerden	jodu
extraordinary	favqulodda
sting	dog '
kind	mehribon
700	700
shaped	shakllangan
â±	â ±
interested	manfaatdor
impressions	taassurotlar
ã¢ââs	Ã â € ™ romati
2012	2012 yil
unforgettable	unutilmas
language	til
sheets	choyshablar
campsite	lager
paradise	jannat
turned	o'girildi
lcd	lcd
boring	zerikarli
alphons	Alfalar
guest	mehmon
flavouring	lazzat
wide	keng
bike	velosiped
oterwise	aks holda
moved	Ko'chib
cannot	mumkin emas
westminster	vestminster
urine	siydik
school	maktab
beautiful	chiroyli
wine	vino
hell	do'zax
bilbao	bibao
bar	bar
attractions	Yig'ilishlar
seashore	dengiz qirg'og'i
orly	og'iz
those	o'shalarga
advantage	afzallik
ã¡gent	Ọgent
tuscany	tinch
smoked	dudlangan
traffic	tirbandlik
damage	zarar
sunday	yakshanba
deter	tiklamoq
double	ikki baravar
near	yaqin
bob	bob
cooks	oshpazlar
overall	umumiy
flight	parvoz
seems	ko'rinadigan
italien	Italiya
if	agar
fab	fab
usually	odatda
even	hatto
restoration	qayta tiklash
will	iroda
renovarted	Qayta tiklangan.
fridge	muzlatgich
baku	bokuda
most	ko'p
area	maydoni
evening	oqshom
century	asr
lanka	lina
tha	Men xohlayman
road	yo'l
desired	orzu qilingan
some	biroz
other	boshqa
uncomfortable	noqulay
flag	bayroq
outdoor	ochiq
receptionists	Qabul qiluvchilar
smart	aqlli
climbs	qurimoq
class	sinf
apart	alohida
workouts	Mashg'ulotlar
cigarette	sigaret
th	th
pub	pub
him	u
checking	tekshirish
heavy	og'ir
pretty	juda chiroyli
travelodge	sayr qilmoq
suite	sulog
surprise	ajablanib
relaxed	bo'sh
sqm	kvachilik
pass	pas
miami	miami
served	xizmat qiladigan
cocktails	kokteyl
ls	ls
full	to'la
situation	vaziyat
computers	Kompyuterlar
trailer	treyler
hotelthe	Mehmonxona
dorint	dorint
ago	ilgari
denmark	denmark
hearts	yurak
negga	nohaq
beach	plyaj
person	odam
couples	er-xotinlar
locate	topmoq
influence	ta'sir
bad	yomon
unlike	o'xshamagan
fault	ayb
outstanding	taniqli
ã¢â·	Ã ¢
higher	yuqori
messe	chalkashlik
resorts	kurortlar
wear	kiymoq
fee	haq
actually	aslida
noice	noxush
cuase	sabab
intrusive	kuchga kirmaydigan
unfortunately	afsuski
drugs	dorilar
sundays	yakshanba
attentive	ehtiyotkor
foods	Ovqatlar
wonderful	ajoyib
directly	to'g'ridan-to'g'ri
functional	funktsional
stuff	narsalar
rain	yomg'ir
chldren	bolalar
treated	muomala qilingan
word	so'z
stop	STOP
few	oz
thomsons	thunslar
games	o'yinlar
massage	massaj
much	ko'p
metro	metro
efficiently	samarali
animaters	Animatorlar
subway	metro
offer	taklif qilmoq
selection	tanlash
then	keyin
der	bu
taxi	taksi
sofa	divan
going	bormoq
pillows	yostiq
kindly	mehribon
style	uslub
keep	saqlamoq
team	jamoa
guests	Mehmonlar
sit	o'tirmoq
our	bizning
are	bor
discovery	kashfiyot
entertaintments	Enterfatlar
wanted	istagan
years	yillar
miles	milya
per	har bir
carpet	gilam
back	orqaga qaytish
gone	yo'qolgan
running	yugurish
genuine	chinakam
sã£â¶dermalm	£ Yodmmtalm
montjuic	monaju
we	biz
choice	tanlash
adjusted	sozlangan
whole	butun
laugh	kulmoq
plan	rejalashtirmoq
itself	o'zi
i	men
immediate	zudlik bilan
according	ko'ra
students	Talabalar
swedish	shvedka
pools	basseynlar
stained	bo'yalgan
euros	evro
enter	kirmoq
detail	tafsilotlar
organization	tashkilot
kids	bolalar
answer	javob
loud	baland ovozda
login	Kirish
lived	yashagan
mall	savdo markazi
leave	qoldirmoq
hospitable	mehmondo'st
quickly	tezda
when	qachon
idem	xuddi shu
deventer	Devent
standards	Standartlar
placement	joylashtirish
upgrade	yangilamoq
complaints	Shikoyatlar
card	kartochka
windows	derazalar
la	bu
trafford	savdotor vositasi
saturday	shanba
owners	egalari
polite	muloyim
friends	do'stlar
don	don
surely	shubhasiz
sri	sri
bands	guruhlar
cologne	odeka
returning	qaytish
remember	esda tutmoq
negative	salbiy
regrettably	achinarli
paied	pay
please	Iltimos
mostly	asosan
where	qayerda
self	o'zini
during	davrida
found	topilgan
attending	qatnashish
palace	saroy
spoken	og'zaki
fast	tez
juices	sharbatlar
hof	xof
shops	do'kon
spot	joy
1	1
it	u
size	o'lcham
passed	o'tkinchi
rented	ijaraga olingan
olso	zolim
emily	emuly
kã£â¶ln	kã £ musan
prefer	afzal ko'rmoq
prompt	tez
month	oy
cleaned	tozalamoq
ceiling	shift
sat	o'tirdi
siena	sena
work	ish
places	joylar
first	avval
bathrooms	hammom
claiming	da'vo
tasted	tatib ko'rmoq
stuck	yopishib olmoq
duck	o'rdak
scenic	sahnaga oid
highlights	diqqatga sazovor joylar
complaint	shikoyat
spoiled	buzilib ketgan
storage	saqlash
among	orasida
including	shu jumladan
charm	joziba
inside	ichkarida
supburb	supurgi
locally	mahalliy
wooden	yog'och
therethank	The The
ã¢â´	Ã ¢ â
handled	ishlov bermoq
towels	sochiq
timely	o'z vaqtida
ã£â¡gent	Â ¡
refurb	tuzatmoq
vouchers	vaucherlar
extremly	o'ta
surprised	hayron qolgan
food	ovqat
eyesi	Ko'zi
13	13
explain	tushuntirmoq
foyer	foyer
airport	aeroport
complained	shikoyat qildi
stations	stantsiyalar
14	14
dishes	idishlar
helped	yordam berdi
frienly	Do'stona
pension	pensiya
enjoyable	yoqimli
things	narsalar
thoroughfare	garov
minded	fikrli
conected	ulangan
breaker	buzuvchi
comforts	qulaylik
youngsters	yoshlar
decor	bezamoq
jelly	jele
nevertheless	shunga qaramay
10m2	10 m2
needs	ehtiyoj
wc	Hojatxona
worn	eskirgan
outlet	rozetka
european	evropalik
pleasure	zavq
courteous	xushmuomala
bellmen	beldosh
system	tizim
tag	yorliq
9years	9 yosh
organised	uyushgan
stains	dog'lar
chain	zanjir
february	fevral
madrasses	madrasas
stars	yulduzlar
soap	sovun
beware	ehtiyot bo'ling
faded	xira
painting	rasm
rail	temirchi
absolute	mutlaq
platinum	platina
coffee	kofe
aerea	antenna
frequent	tez-tez
constriction	qurilish
presented	taqdim etilgan
plage	Plyaj
b	b
order	tartib
days	kunlar
walking	yurish
deprived	mahrum qilmoq
non	nobud bo'lmagan
appart	do'zax
position	pozitsiya
touring	sayr qilish
supervicion	nazorat
teenagers	o'spirinlar
disco	diskoteka
quit	ketmoq
confirmation	tasdiqlash
bathtub	vanna
still	hanuzgacha
while	vaqt
delivery	yetkazib bermoq
reason	sabab
might	qudrat
staff	xodimlar
wich	fohisha
decorated	bezatilgan
offered	taklif qilingan
offering	qurbonlik qilmoq
rose	atirgul
lanxess	lanxess
cycling	velosiped
inspection	tekshirish
extrasthe	Ekstrazsiya
finishes	tugatadi
vas	siz
following	quyidagi
also	shuningdek
entertainment	o'yin-kulgi
nicest	eng yaxshi
languages	tillar
construction	qurilish
compact	ixcham
cleanest	toza
party	partiya
minority	ozchilik
swimming	suzish
schhh	schhh
price	narx
countries	Mamlakatlar
quicker	tezroq
jumeriah	shimira
placed	joylashtirilgan
moquette	gilam
weather	ob-havo
speaks	gapiradigan
noticed	ko'rilgan
greeted	salomlashish
spa	spa
driving	haydash
touchwith	sho'ka
recently	yaqinda
pants	shim
bikes	velosiped
expectation	kutish
angry	badjahl
were	edi
cottages	Sottalar
afew	biroz
into	ichiga
disgusting	jirkanch
older	katta
huge	ulkan
aside	bir chetga surmoq
spending	sarflash
something	nimadur
easy	oson
floor	zamin
swiming	suzish
funiture	mebel
responsible	javobgar
above	yuqorida
safe	xavfsiz
just	shunchaki
les	bu
signal	signal
willing	tayyor
assorted	irodasi
cleaning	tozalash
awayas	sonlar
safety	xavfsizlik
up	yuqoriga
lousy	lusy
clean	tozalamoq
pc	kompyuter
give	bermoq
letdown	qo'yib yuborish; ishonchni oqlamaslik
cater	ovqatlantirmoq
shabby	shim
mountain	tog
go	bormoq
periferique	perifezeriq
close	yaqin
performance	ijro etish
gentle	yumshoq
be	bo'lmoq
strip	tasma
ate	yemoq
way	yo'l
business	biznes
purposed	tushunar edi
concept	tushuncha
portions	qismlar
get	olmoq
allow	ruxsat bermoq
occasions	holatlar
bookingcom	kitoblashuv
george	Jorj
washbasin	linabozin
complex	murakkab
restaurat	tikilish
octoberfest	oktoberfest
late	kechqurun
vice	jinoyat
unhappy	baxtsiz
utrecht	urtecht
busy	band
egypts	Eget
weal	mug'ambirlik qilmoq
tired	charchagan
hours	soat
setting	sozlamoq
azerbaijan	Ozarbayjon
realised	amalga oshirildi
ours	bizniki
dj	dj
break	sindirish
dreamy	xayolparast
elegance	nafislik
riverside	daryolar
transportation	tashish
destination	belgilangan joy
friendliness	do'stlik
rated	baholash
travellers	sayohatchilar
3am	umumiy
not	emas
staying	qolish
roll	rulon
attitude	munosabat
finally	nihoyat
bridge	ko'prik
diner	oshxona
men	erkaklar
eight	sakkiz
modest	kamtar
croissants	krositsiya
beginning	boshi
alive	tirik
chipped	chayqalmoq
manager	menejer
knifes	kchinalar
pictures	rasmlar
online	onlayn
fashioned	moda
greets	salom
centre	markaz
cokes	kokslar
least	eng kam
piece	bo'lak
decorative	bezak
convenience	qulaylik
ordination	buyruq
preferred	afzal ko'rgan
rotten	chirigan
a	a
lighting	yoritish
tried	sinab ko'rdi
everyday	har kuni
lounge	zanjir
july	iyul
looking	qarash
customers	xaridorlar
takes	davom etadi
british	britaniyalik
quality	sifat
washing	yuvish
encountered	duch kelgan
may	mayl
mr	Janob
establishments	Maslahatlar
high	baland
wall	devor
lyon	lyon
awful	dahshatli
stunning	ajoyib
seeing	ko'rish
intervene	aralashmoq
lobby	lobbi
attendance	qatnashish
climbing	ko'tarilish
planning	rejalashtirish
end	oxiri
fountain	favvora
mention	aytib o'tmoq
pull	Torting
floods	toshqin
ample	mo'l-ko'l
worths	arziydi
sister	singil
partner	sherik
pluss	qo'shimcha
3rds	3-chi
revisiting	tiklamoq
support	qo'llab-quvvatlash
dirtyour	dirad
delicious	mazali
managed	boshqariladigan
shame	uyat
pickpocketing	po'stloq
bath	Vanna
unique	noyob
edible	yesa bo'ladigan
looks	ko'rinadigan
throughout	butunlay
totally	butunlay
started	boshlandi
after	keyin
hour	soat
organized	uyushgan
ms	Xonim
maker	ishlab chiqaruvchi
mgmt	mgmt
robbed	talon-taroj
keeping	saqlamoq
weekenders	Dam olish kunlari
liable	javobgar
family	oila
marseillan	marslan
experience	tajriba
approx	taxminan
water	suv
tourist	sayyoh
deal	bitim
dancers	raqqosalar
cars	avtomobillar
minus	minus
twist	buramoq
cultures	madaniyatlar
pay	to'lash
personally	shaxsan
atmosphere	atmosfera
surrounding	atrofdagi
cooperation	hamkorlik
ther	tiniq
nightclubs	tungi klublar
tuscan	teri
your	sizning
well	yaxshi
rat	kalamush
vieuz	vieuz
middle	o'rtada
rock	tog 'jinsi
times	vaqt
taken	olingan
life	hayot
croissant	kroslar
pathã©	Pavol ©
restricted	cheklangan
adjacent	qo'shni
beverage	ichimlik
shop	do'kon
member	a'zo
regard	hurmat
though	Garchi
checked	tekshirilgan
jam	murabbo
careful	ehtiyotkor
relatively	nisbatan
alley	xiyobon
boy	bola
heard	eshitgan
residential	Aholi yashash joyi
grab	ushlamoq
request	talab qilmoq
smoking	chekish
discount	chegirma
pricey	tripey
redeeming	sotib olish
an	a
husaband	Xeyvenand.
n	n
troubles	muammolar
cleaness	tozalik
ride	sayr qilmoq
etiquette	odob-axloq qoidalari
sound	tovush
fairly	odilona
ll	ll
75	75
luxuries	hashamat
since	botgan
advantadge	afzallik
german	nemis
products	Mahsulotlar
useless	foydasiz
outdated	eskirgan
exelent	qurt
behind	orqasida
let	ijozat bering
entertain	ko'ngil ochmoq
sous	ostida
walked	yurarkan
downtown	markaziy markaz
louvre	lovet
telling	gaplashmoq
cancelation	Bekor qilish
recommendable	tavsiya etilgan
big	katta
connect	ulanmoq
average	o'rtacha
tram	tramvay
hte	hte
amasing	eskirgan
egypt	misr
bread	non
calling	qo'ng'iroq
reasons	sabablar
smsevery	SMS
thessaloniki	salonkoniki
cleanliness	tozalik
based	asos
beyond	narida
russians	Ruslar
hermitage	ermitaj
age	yosh
160	160
trip	sayohat
morning	ertalab
sã¶dermalm	sãumdmalm
5	5
although	garchi
instead	o'rniga
balcony	balkon
gym	sportzal
extremely	juda
smelt	eritma
blend	aralashtirmoq
hotelmanager	mehmonelmanger
freezing	muzlash
expense	xarajat
welcome	xush kelibsiz
problem	muammo
another	boshqa
later	keyinchalik
never	hech qachon
option	imkoniyat
90th	90-chi
perfect	mukammal
vitosha	vitshalar
ã¢ââ¬	Ã ¢ ¬â
at	da
coach	murabbiy
tasty	mazali
paid	to'langan
street	ko'cha
expectations	taxminlar
timing	vaqt
nothing	hech narsa
mohamed	Mochil
visited	tashrif buyurilgan
can	mumkin
singke	Sekx
tea	choy
alanani	O'yin tugmasi
elysee	ellik
plus	qo'shimcha
rate	baholamoq
pm	bosh vazir
aqua	aqua
olive	zaytun
acoustic	akustik
mistake	Xato
concierge	kelishuv
tee	tee
stay	turmoq
â	â €
vehicles	transport vositalari
arranged	tartibga solingan
screen	ekran
competences	vakolat
pompidou	pompidou
steakhouse	chaqqon
november	Noyabr
pool	pul
allowing	ruxsat berish
down	pastga
verz	oyat
originally	avvalo
advertised	e'lon qilingan
healthy	sog'lom
50	50
top	eng yuqori
menus	menyular
sheraton	sheraton
wellness	yaxshi
front	old
dance	raqsga tushmoq
par	orqali
requests	So'rovlar
ever	har doim
ask	so'rang
re	qaytadan
zone	zona
ã¢âât	Ã â € ™ â € ™ â €
away	uzoqda
amenities	Xulq-atvor
shuttle	shilmoq
eur	Yevro
streets	ko'chalar
cheap	arzon
met	uchrashmoq
active	faol
welcomed	ma'qullangan
reputation	obro'si
turkish	turkcha
items	narsalar
taught	o'rgatilgan
robe	xalat
continental	qit'a
take	olmoq
spoilt	buzilib ketgan
playing	o'ynash
terrible	qo'rqinchli
sol	sol
aimee	aimee
holidaymy	bayram
rubber	kauchuk
rough	qo'pol
meals	ovqat
c	t
connected	ulangan
upstairs	yuqori qavat
children	bolalar
safisfied	qanoatlantiradigan
each	har biri
explanation	tushuntirish
provided	taqdim etilgan
employees	Xodimlar
abit	ozgina
quiet	jim
early	erta
whenever	har doim
departure	jo'nash
visiting	tashrif buyuradigan
allwe	All
problems	muammolar
pre	oldindan ko'rmoq
spend	sarflamoq
play	o'ynash
ã£â	Ã £ bir funt
annoying	zerikarli
cocktail	kokteyl
minibar	mikroavtobus
reef	rif
reliable	ishonchli
staffthe	Xodimlar
cost	narx
world	dunyo
cut	kesmoq
diffrent	tarang
champs	champlar
trier	sherigi
their	ularning
public	ommaviy
fitness	fitness
steak	chakalak
choose	tanlamoq
roomstaff	Xona xonasi.
unclog	yechmoq
tastes	did
ancient	qadimiy
anna	anna
underground	yer osti
hear	eshitmoq
simplistic	sodda
around	atrofida
scrambled	pishirilgan
beer	pivo
myself	o'zim
part	qism
smallest	eng kichik
wi	Va
watching	tomosha
walkways	yo'l
reasonable	oqilona
nevskii	Nevsskiy
town	shahar
comfortablelounge	qulay
ham	dudlangan cho'chqa go'shti
aquagym	aquachim
oliver	oliver
25	25
maxxiland	mixxiland
bliss	saxiy
site	sayt
return	qaytish
light	yorug'lik
twice	ikki marta
job	ish
finest	eng yaxshi
mean	anglatadi
bulgaria	bulgariya
invite	taklif qilmoq
tended	qiynalmoq
recomended	qayta ko'rib chiqilgan
felt	his qilmoq
furnished	jihozlangan
neightborhood	Turar joy dahasi
respective	tegishli
steps	qadamlar
fi	bo'lmoq
impossible	imkonsiz
drinks	ichimliklar
somewhere	biror joyda
madrid	madrid
sunny	quyoshli
me	men
rather	ancha
pyramid	piramida
funny	kulgili
payed	to'langan
theres	terilar
profession	kasb
singer	ashulachi
lose	yo'qotish
patient	bemor
couple	er-xotin
tend	moyil
load	yuklamoq
champ	champ
enjoyed	zavq bag'ishlagan
trash	axlat
pirates	qaroqchilar
stag	sadoqatli
expensive	qimmat
checkin	belgilanish
offers	takliflar
blonde	sarg'ish
intersection	chorraha
therefore	shu sababli
balu	to'p
convenient	qulay
animators	Animatorlar
mondays	dushanba
bedding	choyshab
visit	ziyorat qilmoq
toast	tost
center	markaz
ã¢ââd	â € ™ z
day	kun
vineyards	uzumzorlar
feb	fevral
chaos	betartiblik
tiling	egiluvchan
range	oraliq
breakfast	nonushta
dinner	kechki ovqat
refurbishment	esdan chiqarish
seven	Yetti
name	ism
dolphin	delfin
putting	zinapoya
argue	bahslashmoq
weekend	hafta oxiri
leaking	oqmaydigan
weekly	haftalik
taste	tatib ko'rmoq
ridiculous	kulgili
min	men
juice	sharbat
nightclub	Tungi klub
trams	tramvay
comparing	taqqoslash
mexican	meksikalik
club	klub
course	kurs
pond	hovuz
group	guruh
actual	haqiqiy
gold	oltin
show	ko'rsatish
week	hafta
stores	do'konlar
1st	1-chi
swipe	surmoq
triump	zafar
connections	Ulanishlar
8	8
kallithea	kaliteya
pantaneto	Panteneto
needwe	ehtiyojlar
reach	yetmoq
character	xarakter
arrivals	Qaytish
cause	sabab
affordable	eng maqbul
aerobicthey	aerobitsi
colorful	rangli
mins	minalar
volvereta	Volvereta
variety	xilma-xillik
located	joyida joylashgan
24	24
luxurious	hashamatli
sensational	sezgi
used	ishlatilgan
anyway	nima bo'lganda ham
arc	yoy
tub	vanna
practically	amalda
york	shayton
special	maxsus
worse	yomon
roof	tom
international	xalqaro
key	kalit
numerous	ko'p sonli
bus	avtobus
living	yashash
suprised	hayron qolgan
hostel	arzon mehmonxona
largest	eng katta
new	yangi
corridor	yo'lak
great	ajoyib
made	yasama
holidys	Bayramlar
additional	qo'shimcha
eurostar	salostar
renovated	tiklangan
cafe	kafe
acommodation	turar joy
gardens	bog'lar
personal	shaxsiy
lights	chiroqlar
amstel	amaki
melia	mushak
pot	qozon
ad	reklama
repeat	takrorlamoq
dirty	iflos
starting	boshlamoq
hr	hr
hardware	apparat
internet	Internet
acceptable	maqbul
excecutive	ijro etuvchi
excelent	yuksak
like	o'xshash
commonly	odatdagidek
importen	import qilish
sign	belgi
lord	lord
now	hozir
highway	katta yo'l
interest	qiziqish
reseption	ziyofat
updated	Yangilangan
providing	ta'minlash
book	kitob
colors	ranglar
live	jonli
moments	lahzalar
bathroom	hammom
failed	muvaffaqiyatsiz
legs	oyoqlari
surroundings	atrof
over	ustida
pastry	xamir
someone	kimnidir
was	edi
restored	tikilish
length	uzunligi
members	a'zolari
midnight	yarim tunda
definetely	albatta
classiest	eng yaxshi
case	ish
secure	himoya qilmoq
began	boshlangan
except	bundan mustasno
pluspoint	mo'l-ko'l
namely	ya'ni
liquires	suyuqlik
free	ozod
creaky	xiralik
copenhagen	kopengagen
leaving	ketish
didn	yolg'on gapirmoq
verry	qiyalik
hard	qattiq
really	chindan ham
2	2
allowed	ruxsat berilgan
before	oldin
dine	sizniki
villa	villa
said	dedi
express	ifoda etmoq
9	9
happened	sodir bo'ldi
cleaners	Tozalash vositalari
train	poezd
wash	yuvmoq
chic	chi
worst	eng yomon
prostitutes	fohisha
thats	bu
oriented	yo'naltirilgan
ideally	ideal
tonic	tonik
heating	isitish
gran	ajoyib
three	uch
suprise	hayron
pubs	pablar
here	Bu yerga
borring	BARBRING.
beautifully	chiroyli
service	xizmat
nearly	deyarli
alternation	almashtirish
hallmark	zal
lines	chiziqlar
bring	olib kelmoq
repair	tuzatish
till	ga
until	gacha
hi	salom
fit	moslashtirmoq
lamps	chiroqlar
ihad	istalgan
1mile	1 milya
oberoi	obro'li
status	holat
proximity	yaqinlik
casa	Uy
deira	deira
mail	pochta
neighborhoods	mahallalar
fully	to'la
hand	qo'llamoq
plays	spektakl
architecture	arxitektura
variuos	har xil
london	london
desk	stol
dusting	changlash
loved	sevgan
call	qo'ng'iroq qilmoq
neighbourhood	Turar joy dahasi
sray	karvonsaroy
ala	ala
everytime	har safar
roadside	yo'l bo'yida
us	Biz
disappointed	ko'ngli qolgan
lifestyle	turmush tarzi
ã¢ââ	â € â € â € â € â € â € â € â € â € â €
everything	hamma narsa
spiderweb	spiderweb
needed	zarur
espaccely	bedarak
exchanging	almashinuv
varied	turli-tuman
entrance	Kirish
seen	ko'rilgan
dining	ovqatlanish
professionell	professional
amel	harakat
ready	tayyor
adults	kattalar
became	ga aylandi
kã¶ln	kayf
rooms	Xonalar
pleasantly	yoqimli
two	ikki
couldn	bo'lmadi
process	jarayoni
amp;	amp;
say	demoq
requested	talab qilingan
equipped	jihozlangan
could	mumkin
clerk	kotib
upper	yuqori
especially	ayniqsa
conditioning	konditsionerlik
18	18
carlton	daryo
broken	singan
coming	kelish
cottage	yozgi uy
walk	sayr qilmoq
vivaldi	vivaldi
worries	tashvish
salute	salomlashmoq
touristic	turistik
anywhere	har qanday joyda
areas	joylar
2013	2013 yil
faults	yoriqlar
extended	cho'zilgan
attitudes	munosabat
resort	kurort
only	faqat
travelled	sayohat qilingan
comments	Izohlar
kinds	turlari
number	raqam
weekends	dam olish kunlari
same	bir xil
professional	professional
antic	o'tmishdagi
handle	tutqich
espresso	espresso
failure	muvaffaqiyatsizlik
property	mulk
choises	Tanlovlar
dorm	dor
florence	florensiya
shower	dush
smell	hid
round	aylana
its	uning
belongings	narsalar
isolation	izolyatsiya
fresh	yangi
whilst	qaysar
drunk	mast
view	ko'rinish
alright	yaxshi
comprehensive	keng qamrovli
ve	va
breakfasts	nonushta
nl	nl
does	qiladi
meal	ovqat
haven	boshpana
contemporary	zamonaviy
her	u
ât	â € ™ t
replenished	to'ldirilgan
cheese	pishloq
face	yuzma-yuz
having	bor
on	yoqilgan
private	xususiy
akward	noqulay.
thank	rahmat
pity	achinish
itc	itc
usual	odatiy
smiling	jilmayish
getting	olish
meny	menyu
nice	yaxshi
feeling	his-tuyg'u
seaside	dengiz bo'yi
mixed	aralashgan
ervery	har bir
everybody	hamma
dissapointed	og'adigan
definitely	albatta
almost	deyarli
fabulous	ajoyib
possibly	ehtimol
small	kichik
has	bor
cant	kamaydi
facility	qulaylik
availability	mavjudlik
am	men
present	hozirgi
aforesaid	yuqorida aytib o'tilgan
serve	xizmat qilmoq
room	xona
map	xaritasi
jacuzzi	jakuzzi
dive	sho'ng'ish
start	boshlamoq
thought	o'ylamoq
booking	bron qilish
waiter	Ofitsiant
fact	fakt
dvd	dvd
mobile	mobil
wife	xotin
step	qadam
observations	Kuzatuvlar
girl	qiz
indication	ko'rsatma
star	Yulduz
condition	shart
others	boshqalar
current	hozirgi
minimal	minimal
designed	rejalashtirilgan
compared	solishtirma
dirtyentertainment	ifloslik
points	Ballar
picturesque	chiroyli
tell	aytmoq
tasteswe	ta'mi
hundred	yuz
dish	idish
casino	kazino
works	ish
shopping	xarid qilish
junior	kichik
interesting	qiziq
touch	tegmoq
too	ham
ingeniously	juda
afterwards	keyin
print	bosib chiqarish
versa	aksincha
surprisingly	Ajablanarsiz
maximum	maksimal
attended	qatnashgan
hot	issiq
hamburger	gamburger
marvellous	ajoyib
line	chiziq
âll	â € ™ zbekiston
trouble	qayg'u
mega	mega
modern	zamonaviy
second	ikkinchi
wish	istak
workers	ishchilar
pleases	zavq
major	katta
passing	o'tkinchi
interestingin	Qizg'in
kassandria	kazsandriya
heaven	osmon
snorkeling	snorkeling
behold	ko'rkam
apartments	kvartira
enmenons	Enzor
wheel	g'ildirak
blue	ko'k
helpfull	yordam beruvchi
soup	sho'rva
fulfilling	bajarish
specially	alohida
wil	hohlamoq
yes	ha
bacteria	bakteriyalar
holidays	Bayramlar
bass	bas
activities	Faoliyat
hamam	Vanna
bistro	pikzat
four	to'rt
quick	tez
proffesional	professional
reservations	Rezervasyon
marinachania	marina
mini	mini
dogs	itlar
local	mahalliy
paths	yo'llar
low	past
keys	Kalitlar
heater	isitgich
amp	amp
evan	evavan
looked	qaradi
elysees	Elieses
visible	ko'rinadigan
insulation	izolyatsiya
allows	ruxsat beradi
hosts	Xostlar
martha	marta
helpful	foydali
turkey	kurka
typical	odatiy
coktailsstaff	koktailsstaff
paper	qog'oz
brings	olib keladigan
spreads	tarqaldi
ration	ratsion
off	o'chirilgan
taxis	Taksilar
cheaper	arzonroq
dame	eram
tp	tp
getaway	ketmoq
marvelous	ajoyib
television	televizor
fatal	halokatli
regular	muntazam
association	uyushma
environment	atrof-muhit
yet	hali
hade	bor edi.
extra	qo'shimcha
agia	aqidasi
recognize	tanimoq
player	o'yinchi
territory	yer
window	deraza
horrible	dahshatli
recommendations	Tavsiyalar
relaxing	bo'shashish
due	to'langan
guy	yigit
fantastic	hayoliy
however	ammo
spacious	keng
supported	qo'llab-quvvatlanadigan
brits	brits
duomo	duom
stupid	ahmoq
ages	asrlar
must	shart
ok	ok
black	qora
pizza	pizza
economically	tejamkor
70s	70 x
doesen	halokat
car	mashina
point	nuqta
charming	maftunkor
didnt	qilma
betting	tikish
somewhat	biroz
breaks	tanaffus
entire	butun
goavoid	geraoid
disclose	oshkor qilmoq
incredible	aql bovar qilmaydigan
forward	oldinga
efficient	unumli
decent	munosib
fitted	jihozlangan
his	uning
given	berilgan
haque	boks
note	Eslatma
minutes	daqiqa
fine	yaxshi
276	276
visits	tashriflar
assoiated	bog'langan
considering	hisobga olgan holda
overpriced	juda ko'p
axaha	elb
everyone	hamma
less	Kamroq
floaties	Sozlar
cared	g'amxo'r
m	shodlik
land	yer
staircase	zinapoya
simple	oddiy
do	qilmoq
destinations	joy
bathrobes	vanna
function	funktsiya
varieous	xilma-xil
ensures	ta'minlaydi
brussels	bryussel
eran	edi
improved	yaxshilangan
travelers	sayohatchilar
30th	30-chi
cuisine	oshxona
forthcoming	kelgusi
considered	deb hisoblangan
families	Oilalar
positive	ijobiy
boulevar	xiyobon
able	qodir
pleaseure	zavq
vacationpickalbatros	Bo'shatishpicalbotro
thanks	rahmat
likely	ehtimol
extreme	haddan tashqari
exercise	mashq qilmoq
yard	hovli
reality	haqiqat
seasight	shimoliy
tournaments	Turnirlar
awfull	afsuslanmoq
best	eng yaxshi
drink	ichimlik
want	xohlamoq
disadvantage	noqulaylik
disclosed	oshkora
last	oxirgi
marley	marafa
wonderfull	ajoyib
decided	qaror qabul qildi
respects	hurmat
wasnt	isnt
shows	Shou
hostess	uy egasi
asked	so'radi
suggest	taklif qilmoq
months	oylar
out	tashqarida
12	12
exposed	fosh qilingan
rungis	rungis
attractive	jozibali
covered	yoritilgan
adequate	to'g'ri
cold	sovuq
straight	Streyt
short	qisqa
mood	kayfiyat
persons	shaxslar
happiness	baxt
louise	luiza
excursions	ekskursiyalar
stone	tosh
reached	yetib bordi
greek	yunon
cracked	yorilgan
backing	zaxira
within	ichida
hopping	sakrash
usd	USD
talking	gapirish
steigenberger	steigenberger
apply	qo'llamoq
kitchen	oshxona
â	Obna
redecorated	qayta tiklangan
reply	javob bermoq
explore	o'rganmoq
value	qiymati
tower	minora
people	odamlar
respected	hurmatga sazovor
bother	bezovta qilmoq
basic	Asosiy
exceeded	oshib ketgan
imposible	imkonsiz
she	u
mum	mum
meat	go'sht
monmarte	monastir
yoghurt	yogurt
rates	stavka
closes	yopiladi
castelo	Qal'a
escalator	eskalator
gorgeous	ajoyib
vodka	aroq
pipes	quvurlar
through	orqali
30	30
important	muhim
