talking	V
anyone	NN
rude	NN
expect	V
provide	IN
earth	NN
alright	ADV
all	DT
students	NNS
700	CD
rules	NNS
namely	ADV
carparking	V
per	IN
c	NN
8	CD
restful	ADJ
nevertheless	ADV
why	WRB
claustrophobic	ADJ
big	ADJ
level	NN
dubai	NN
has	V
show	V
spoilt	ADJ
once	ADV
entertain	V
taste	NNS
mistake	V
manager	NN
elevator	NN
dated	V
quickly	ADV
sasha	V
gone	V
centre	ADV
reached	V
disappointed	V
i	NN
after	IN
food	NN
joy	NN
got	V
managed	V
done	V
etiquette	NN
hopping	V
behind	IN
assist	ADJ
likewise	NN
mainly	ADV
flower	ADV
renovated	V
desired	ADJ
pompidou	NN
mgmt	ADJ
heart	NN
hundred	V
adult	NN
extremly	ADV
out	RP
ultra	ADJ
conclusion	NN
since	IN
signal	ADJ
considering	V
sky	ADJ
75	CD
careful	ADJ
normally	ADV
peoplethe	ADJ
situation	NN
totally	ADV
4	CD
hospitality	NN
euros	NN
tub	NN
is	V
ate	ADJ
pants	NNS
clean	ADJ
than	IN
local	ADJ
amenities	NNS
eyesi	V
floaties	NNS
middle	V
utrecht	ADJ
expensive	ADJ
excelent	NN
south	NN
choose	ADJ
pricey	NNS
gladly	ADV
market	NN
rat	NN
tiny	ADJ
helped	V
cigarrum	V
deserts	NNS
via	IN
own	ADJ
kids	NNS
ideal	V
regard	ADJ
keys	NNS
eight	CD
altstadt	NNS
floor	NN
alanani	ADJ
antic	ADJ
city	NN
pm	NN
wil	V
realised	V
following	V
verry	NN
neighbourhood	ADV
visited	V
windows	NNS
bugs	NNS
2nd	CD
solved	V
phone	NN
elegant	NN
pools	NNS
redecorated	V
hermitage	NN
sit	NN
been	V
steak	ADJ
real	ADJ
spakenburg	NN
opportunitys	ADJ
transportation	NN
ground	NN
receptionists	V
120	CD
anything	NN
2011	CD
corner	NN
seen	V
interior	ADJ
meetings	NNS
inedible	ADJ
finest	ADJ
he	PRP
ve	V
robbed	ADJ
pluss	IN
rebuilding	V
end	NN
animaters	NNS
unconfortable	ADJ
difficult	ADJ
inner	NN
damaged	V
dat	ADJ
sleep	NN
yoghurt	NN
studio	NN
money	NN
opinion	NN
smelled	V
superfriendly	ADV
siro	ADJ
attractions	NNS
mins	NNS
germans	NNS
relaxing	V
copenhagen	NN
november	NNS
disclosed	V
stephanie	ADJ
though	IN
5	CD
supermarket	NN
fitness	NN
shopping	NN
walk	NN
unhappy	ADJ
map	NN
checking	V
waiter	NN
daytime	NN
available	ADJ
package	NN
upper	ADJ
talk	NN
nothing	NN
lifestyle	NN
heated	V
usd	ADJ
conference	NN
espaccely	ADV
base	ADJ
boys	NNS
noticed	V
match	NN
regular	ADJ
cleanliness	NN
brandy	NN
âs	NNP
bookingcom	NN
seashore	V
railway	NN
away	ADV
periferique	ADJ
suit	NN
olso	V
cant	ADJ
drain	NN
ness	ADJ
cinema	NN
visitors	NNS
urine	ADJ
ours	IN
certainly	ADV
azerbaijan	ADJ
italian	ADJ
prefect	NN
stay	NN
sewage	NN
upgrade	ADJ
climation	NN
visible	ADJ
n	ADJ
300	CD
stuck	ADJ
train	NN
surrounding	V
pleasure	NN
thank	NN
worked	V
royal	ADJ
european	ADJ
columbus	NN
interesting	V
trousers	NNS
smoking	V
russian	ADJ
luxuryfood	NN
th	NN
unclog	ADJ
waiters	NNS
travel	V
climbs	ADJ
exelent	NN
byron	NN
lights	NNS
sell	V
maximum	ADJ
friendliness	ADJ
rambla	NN
creaky	NN
love	V
beautiful	ADJ
knew	ADJ
people	NNS
madrid	ADJ
plage	NN
young	ADJ
organization	NN
goes	V
fully	ADV
warm	ADJ
cooks	NNS
bus	ADJ
swimmingpool	V
efficiently	ADV
lamps	ADJ
reef	NN
delivery	NN
ritz	NN
last	ADJ
members	NNS
add	V
uncomfortable	ADJ
wery	NN
definitely	ADV
when	WRB
date	NN
alternation	NN
low	ADJ
parts	NNS
before	IN
downside	NN
km	NN
reply	NN
tea	NN
able	ADJ
realy	NN
cracked	V
unfortunately	ADV
environment	NN
peopel	NN
establishments	NNS
sunny	ADJ
leeds	NNS
outlet	V
sunrise	NN
teenagers	NNS
cope	V
drink	V
age	NN
your	PRP$
brussels	NNS
want	V
comforts	NNS
lousy	ADJ
woerden	ADJ
disappointing	NN
frills	NNS
elina	V
3	CD
egypt	NN
claiming	V
possibility	NN
round	NN
positive	ADJ
maid	NN
concerning	NN
should	MD
much	ADV
next	ADJ
world	NN
different	ADJ
meters	NNS
linens	V
various	ADJ
belongings	NNS
smooth	CC
incredible	ADJ
rer	NN
cover	NN
feast	NN
definitively	ADV
tallinn	ADJ
shower	ADJ
vacationpickalbatros	NNS
trying	V
brocken	ADJ
please	NN
earned	V
travelodge	$
3rds	CD
speaking	V
reasonable	ADJ
chears	NNS
pond	IN
toast	NN
scandic	NN
prepared	V
mean	ADJ
begrudge	NN
maybe	ADV
office	NN
remark	NN
transition	NN
best	ADJ
price	NN
shows	NNS
common	ADJ
breaks	NNS
outstanding	ADJ
diffrent	ADJ
residents	NNS
couldn	V
otherwise	ADV
improved	V
leisure	NN
take	V
open	ADJ
rent	NN
animations	NNS
camp	V
convention	NN
martha	NN
3am	CD
min	NN
weeks	NNS
by	IN
1st	CD
miami	NNS
needwe	ADJ
ask	IN
absolute	ADJ
montmartre	NN
purposed	V
sofa	ADJ
pantaneto	NN
notre	ADJ
smart	ADJ
lighting	V
restaraunts	NNS
straight	ADJ
girl	NN
basic	ADJ
grill	NN
vice	NN
at	IN
roll	NN
shoes	NNS
deventer	ADV
superb	ADJ
pay	NN
housekeeping	V
helpful	ADJ
discounts	NNS
nights	NNS
aldo	V
experience	NN
boring	NN
believe	V
and	CC
a	DT
jacuzzi	NN
tasteswe	NN
won	V
iron	NN
throughout	IN
tried	ADJ
exceptional	ADJ
mum	NN
choises	NNS
use	V
picky	ADJ
info	NN
angry	ADJ
track	NN
coktailsstaff	NN
delightful	ADJ
described	ADJ
standard	NN
strip	NN
funny	ADJ
facilties	NNS
keep	V
garage	NN
bring	NN
ã¡gent	NN
based	V
requests	NNS
reserved	V
within	IN
40	CD
hence	NN
dansing	V
enterainment	ADJ
six	CD
four	CD
care	NN
reviews	V
homeless	ADJ
expectations	NNS
such	ADJ
taxi	ADJ
tourist	NN
months	NNS
backpackers	NNS
octoberfest	V
convenient	ADJ
lounge	NN
little	ADJ
centrally	ADV
provides	V
comfortable	ADJ
paying	V
mould	ADJ
bulgaria	NNS
simply	ADV
wellness	ADJ
ervery	NN
polite	NN
accustomed	V
ready	ADJ
we	PRP
mail	V
creative	ADJ
spaces	NNS
explore	V
playground	NN
passed	V
atmosphere	ADJ
remember	V
touristic	ADJ
siena	NN
cottage	NN
rocko	NN
fault	NN
advantadge	NN
oterwise	NN
accomodation	NN
soon	ADV
wall	ADV
timely	ADJ
beaches	NNS
toiletries	NNS
mood	V
flamenco	ADJ
complain	NN
extreme	ADJ
options	NNS
program	NN
absolutely	ADV
minutes	NNS
town	NN
minded	V
trained	ADJ
happened	V
yourself	PRP
narrow	ADJ
quit	NN
steakhouse	NN
trip	NN
makers	NNS
places	NNS
for	IN
grey	ADJ
foreign	ADJ
nicest	ADJ
educated	V
tag	ADJ
arena	NN
whose	WP$
7th	CD
years	NNS
tourists	V
conveniently	ADV
dish	ADJ
into	IN
access	NN
bonus	NN
classiest	ADJ
village	NN
arranged	V
line	NN
despite	IN
monmarte	NNS
self	PRP
hip	V
really	ADV
fast	ADJ
shame	NN
balcony	NN
t	NN
vodka	NN
steigenburger	NN
highly	ADV
meat	ADJ
selection	NN
kindness	NN
dancers	NNS
minute	V
video	NN
beginning	V
information	NN
floors	NNS
unique	V
soap	ADJ
view	NN
means	V
ridiculous	ADJ
streets	NNS
connect	V
usual	ADJ
included	V
size	NN
problem	NN
amp;	NN
cleaned	V
thing	NN
5days	CD
stationthe	NN
chosen	V
extrasthe	ADV
economically	ADV
electrical	ADJ
doesen	NN
agia	V
12	CD
legs	NNS
far	ADV
thoroughfare	V
backing	V
surprised	V
the	DT
restored	ADJ
meals	NNS
vitosha	V
smile	ADJ
thats	NNS
arrival	V
music	NN
travelled	V
eur	NN
especially	ADV
con	ADJ
triump	NN
my	PRP$
espresso	NN
70s	CD
wear	ADJ
proximity	NN
foot	NN
hussein	NN
glad	ADJ
quiet	ADJ
part	NN
moved	V
âm	ADV
peaceful	ADJ
excecutive	ADJ
organized	V
makes	V
standards	NNS
neatly	ADV
spoiled	V
decorative	ADJ
ingeniously	ADV
colorful	ADJ
card	NN
customers	NNS
scam	V
informed	V
cologne	NN
betting	V
attending	V
spot	NN
weekend	NN
yes	ADV
strongly	ADV
placed	V
lord	NN
recommend	NN
in	IN
sastisfied	ADJ
refrigerator	NN
needed	V
exposed	V
team	NN
smiling	V
washbasin	NN
cozy	NNS
let	V
hamam	PRP
trouble	NN
booked	V
fresh	ADJ
said	V
ok	ADJ
began	V
tiling	V
vacation	NN
due	ADJ
eurostars	NNS
entire	ADJ
nadia	ADJ
couple	NN
recently	ADV
greets	V
room	NN
trams	NNS
carpet	V
hamburger	ADJ
splendid	ADJ
nearby	ADJ
businesstrips	NNS
happily	ADV
flamingo	V
normal	ADJ
courses	NNS
tee	V
wait	NN
finished	V
surf	ADV
polish	ADJ
generous	ADJ
idea	NN
acoustic	ADJ
heater	NN
parking	V
personnel	NNS
scale	ADJ
coffee	NN
seems	V
men	NNS
travelodges	NNS
defiantly	ADV
thus	ADV
welcomed	V
checked	V
friend	NN
idem	NN
that	WDT
corridor	V
advance	NN
breakfasts	NNS
eurostar	V
gare	ADJ
pluspoint	NN
repair	NN
whenever	WRB
heating	NN
bloody	NN
can	MD
space	NN
genuine	V
slippers	NNS
respects	V
products	NNS
abundant	ADJ
stares	NNS
negga	V
slendid	ADJ
troubles	NNS
families	NNS
nationality	NN
spent	V
both	DT
each	DT
feel	NN
stayed	V
cloth	DT
attended	ADJ
day	NN
drinks	V
lack	V
minimal	ADJ
family	NN
nite	ADJ
state	NN
brought	V
messe	NNS
generally	ADV
impossible	ADJ
cheese	NNS
advertised	V
duck	RP
what	WP
dead	ADJ
respective	ADJ
structure	NN
mess	NN
cars	NNS
hade	V
charm	ADJ
helpfull	NN
fairly	ADV
beaituful	ADJ
robe	NN
construction	NN
linked	V
house	NN
shabby	NN
alive	ADJ
support	NN
pizzeria	NNS
active	ADJ
exceptionally	ADV
modest	ADJ
swiming	V
overall	ADJ
singer	NN
reseption	NN
manicured	V
storage	NN
sablon	NN
fun	NN
setting	V
2013	CD
internet	ADJ
diversity	NN
curtains	NNS
reason	NN
nl	ADV
10m2	CD
character	NN
â	NN
amazing	ADJ
elevators	NNS
come	V
du	ADV
unmatched	ADJ
degrees	NNS
wish	V
numerous	ADJ
frequent	ADJ
tuscan	ADJ
humid	NN
asian	ADJ
clerk	NN
impressions	NNS
adequate	V
five	CD
kinds	NNS
summer	NN
under	IN
started	ADJ
place	NN
recommendation	NN
thrown	IN
american	ADJ
left	V
thanks	NNS
else	ADV
fridge	V
might	MD
stupid	V
8th	CD
looks	NNS
okay	ADJ
underneath	ADJ
plenty	NN
close	NN
of	IN
cost	NN
bubba	NNS
directly	ADV
casa	V
extra	ADJ
â´	NNP
pitch	NN
husband	NN
smoked	V
downtown	ADJ
holes	NNS
hell	V
disgusting	V
delicacies	NNS
massive	ADJ
association	NN
vas	NN
was	V
denmark	ADJ
trafford	ADJ
amstel	NN
unacceptable	ADJ
leaking	ADJ
persons	NNS
or	CC
simple	ADJ
convenience	NN
originally	ADV
firenze	ADJ
checkin	NN
her	PRP$
equipment	NN
varieties	NNS
brilliant	V
palazzo	ADJ
holidys	V
them	PRP
being	V
highway	ADJ
chldren	NNS
water	NN
moments	NNS
door	V
singles	NNS
guests	NNS
terrible	ADJ
gold	ADJ
hour	NN
window	NN
pass	NN
foods	NNS
supburb	V
through	IN
stains	NNS
screen	ADJ
canal	ADJ
kassandria	NN
chair	NN
even	ADV
couples	V
6	CD
maximizes	NNS
cuddle	ADJ
name	NN
fantastically	ADV
least	ADJ
doing	V
definetely	ADV
throw	V
going	V
desk	ADJ
magical	ADJ
london	NN
bland	NN
without	IN
blue	ADJ
down	RP
quick	ADJ
cold	ADJ
calm	NN
y	NN
myself	PRP
bedding	V
dutch	ADJ
side	NN
hotelmanager	NN
somewhat	ADV
tasty	ADJ
weekenders	NNS
exact	V
transfer	V
holidays	NNS
holiday	ADJ
la	ADJ
relations	NNS
black	ADJ
tables	NNS
july	V
off	IN
february	ADJ
collapses	NNS
pirates	V
architecture	V
completely	ADV
liable	ADJ
online	NN
â	NNP
steps	V
vehicles	NNS
willing	ADJ
bike	NN
built	V
unbelievable	ADJ
dusting	V
above	IN
spreads	NNS
destination	NN
lunch	NN
swim	ADJ
pension	NN
ample	ADJ
older	ADJ
consider	NN
fi	NN
something	NN
beds	NNS
castelo	V
meny	ADV
literally	ADV
department	NN
similar	ADJ
shuttle	NN
childrens	NNS
order	NN
forced	V
topaz	NN
never	ADV
pub	V
canine	NN
changes	NNS
profession	NN
faded	V
commonly	ADV
400	CD
look	NN
insisted	V
personally	ADV
b	ADJ
speak	NN
radio	NN
traffic	NN
opera	NN
immidiately	ADV
olive	ADJ
160	CD
charge	NN
tornese	ADJ
booking	V
massage	NN
attendance	NN
meet	NN
very	ADV
always	ADV
alley	V
dinner	NN
cause	NN
wheel	NN
walls	NNS
gilde	V
boulevar	ADJ
candy	NN
using	V
volvereta	ADJ
vineyards	NNS
among	IN
lift	ADJ
eg	V
shous	ADJ
pretty	ADV
experienced	ADJ
sercices	NNS
exceeded	V
visits	NNS
rates	NNS
juices	NNS
14	CD
table	ADJ
slow	ADJ
travelling	NN
beware	NN
exchanging	V
marvellous	ADJ
technology	NN
buy	V
customer	NN
position	NN
amount	NN
several	ADJ
work	NN
comfort	NN
pleasant	ADJ
butt	NN
dorint	NN
terrace	NN
tha	NN
ones	NNS
dine	V
remind	V
amsterdam	ADJ
staff	NN
emily	ADV
mangers	NNS
underground	IN
snorkeling	V
immediate	ADJ
wonderful	NNS
say	V
huge	ADJ
areas	NNS
items	NNS
painting	V
swans	NNS
bad	ADJ
odd	ADJ
brits	NNS
already	ADV
smiles	V
louise	V
dirtyour	NN
offered	V
outside	IN
sheets	NNS
fitnes	V
stone	ADJ
run	NN
became	V
land	NN
workers	NNS
2014	CD
television	NN
relax	NN
waits	V
eran	ADJ
whisky	NN
acceptable	ADJ
wooden	ADJ
hostel	NN
cleaners	NNS
lots	V
darling	V
specially	ADV
mountain	V
impression	NN
life	NN
wonderfull	NN
there	EX
resorts	V
providing	V
chose	ADJ
road	NN
mobile	ADJ
suggest	V
sheraton	NN
affordable	ADJ
partner	NN
stays	V
paper	NN
registration	NN
prompt	IN
major	ADJ
stunning	V
baku	NN
guys	NNS
easily	ADV
call	V
getaway	NN
vieuz	NN
visitor	NN
fee	NN
eat	NN
hr	NN
looked	V
niuewstraat	ADV
non	ADJ
car	NN
maker	NN
pleasantly	ADV
borring	V
ihad	NN
renewed	V
travelers	NNS
aside	ADV
grandaughter	V
together	ADV
easy	ADJ
wouln	NN
everyday	ADJ
perfect	ADJ
scenic	ADJ
tele	NN
ad	NN
metro	NN
another	DT
competences	NNS
facilities	NNS
lovely	ADV
breathtaking	V
other	ADJ
tend	ADJ
times	NNS
favorite	ADJ
rate	NN
swipe	V
many	ADJ
perfume	ADJ
colleagues	NNS
champ	V
powerful	ADJ
good	ADJ
main	ADJ
sufficient	ADJ
rungis	NN
bilbao	NN
riverside	NN
vast	ADJ
loveliest	ADJ
hi	ADJ
aerea	NN
balu	NN
amination	NN
number	NN
average	ADJ
dec	ADJ
picturesque	NN
wilderness	NN
toilet	NN
recommendable	ADJ
â¬	NN
kind	NN
overal	ADJ
contemporary	ADJ
business	NN
nicely	ADV
stuff	ADJ
dance	NN
time	NN
enmenons	NNS
s	ADV
right	ADJ
crazily	ADV
persistent	ADJ
hotels	NNS
here	ADV
re	V
missing	V
noticeable	ADJ
fashioned	V
beach	NN
getting	V
goggle	ADJ
private	ADJ
cleaness	NN
kept	V
feels	NNS
cottages	NNS
hard	ADV
surprising	ADJ
udaivilas	ADJ
sun	NN
few	ADJ
egypts	NNS
to	TO
hte	V
rooms	NNS
poor	ADJ
modern	ADJ
days	NNS
forward	ADV
royalty	NN
jammed	V
tide	ADJ
gets	V
hilton	ADJ
paied	V
oversee	NN
pathã©	NN
stylish	ADJ
step	NN
hot	ADJ
high	ADJ
unforgettable	ADJ
stop	NN
renovarted	V
luxuries	NNS
dress	ADJ
wine	ADJ
distance	NN
gave	V
seven	CD
choice	NN
schiphol	NN
handle	NN
used	V
site	NN
efficient	ADJ
matter	NN
suite	NN
invaded	V
satisfied	ADJ
loved	V
live	ADJ
restaurants	NNS
give	V
mamlouk	NN
avoided	V
choices	NNS
mice	ADJ
staffs	NNS
april	V
boy	ADJ
pleaseure	NN
guest	ADJ
disappointment	NN
disaster	NN
needs	V
repeat	NN
surge	NN
tp	NN
simplistic	ADJ
score	NN
allows	V
pity	NN
ijust	ADJ
example	NN
confusing	V
indeed	ADV
you	PRP
returning	V
twin	ADJ
bacteria	NNS
could	MD
dam	V
these	DT
ignorant	ADJ
evening	NN
then	ADV
noise	ADV
oberoi	ADJ
stag	NN
ensures	V
tuscany	ADJ
feb	NN
equipped	V
conected	V
queue	NN
crowded	V
everyone	NN
boat	NN
behold	V
range	NN
true	ADJ
loud	ADJ
blonde	NN
kettle	NN
â±	NNP
chill	NN
koln	NNP
actually	ADV
complaints	V
partying	V
shoping	V
especialy	ADJ
wonderfully	ADV
ansd	V
trier	ADJ
stops	ADJ
honeymooners	NNS
safety	NN
audience	NN
appreciate	NN
chic	ADJ
how	WRB
mini	ADV
river	V
nor	CC
midnight	ADJ
cafe	NN
silent	ADJ
steam	NN
kitchen	NN
rail	V
up	RP
7	CD
unless	IN
stores	NNS
afraid	ADJ
go	V
thinks	V
en	FW
credit	NN
heavily	ADV
player	NN
anymore	ADV
cereal	NN
located	V
putting	V
quality	NN
entrance	NN
flights	NNS
great	ADJ
serious	ADJ
restaurat	NN
police	NN
know	V
louvre	NN
nevskii	ADJ
actual	ADJ
surely	ADV
cool	ADJ
croissants	NNS
save	V
passing	V
photos	NNS
minuscule	ADJ
torn	ADJ
aerobic	ADJ
delicious	ADJ
enter	NN
revisiting	V
seine	NN
pot	NN
beautifully	ADV
allwe	ADV
largest	ADJ
hurghada	ADJ
reception	NN
pillows	NNS
furnished	V
amasing	V
avoid	ADJ
spirits	NNS
will	MD
girls	V
son	NN
does	V
were	V
facility	NN
cuisine	NN
hoped	V
wi	ADJ
marriott	ADJ
luxury	NN
warmbarman	NN
must	MD
lock	V
hearts	NNS
books	NNS
aerobicthey	V
frankfurt	V
damage	NN
euro	NN
builders	NNS
rimini	V
hospitable	ADJ
visiting	V
proffesional	ADJ
relaxatio	NN
usually	ADV
rated	V
encountered	ADJ
unfriendly	ADV
worn	ADJ
late	ADJ
patient	NN
kuku	NN
every	DT
kã¶ln	NN
miles	NNS
lanxess	ADV
higher	ADJ
halles	NNS
climb	V
named	V
district	NN
having	V
telling	V
floods	NNS
reservations	NNS
seaside	V
welcome	ADJ
touchwith	NN
code	NN
miro	NN
lost	V
dogs	NNS
review	NN
catered	V
station	ADJ
central	ADJ
pizza	NN
stars	NNS
issue	ADV
adjusted	V
touristy	NN
probably	ADV
treatment	NN
dirt	NN
buildings	NNS
attractive	ADJ
sea	NN
spoken	V
discovery	ADJ
shops	NNS
france	NN
liverpool	NN
akward	ADV
costlier	ADJ
attitudes	NNS
ancient	ADJ
hang	NN
organised	V
dust	ADJ
garden	NN
incredibly	ADV
repeatative	ADJ
second	ADJ
attitude	NN
thessaloniki	NN
meal	NN
closes	V
welsh	ADJ
front	NN
boutiques	NNS
held	V
sorted	ADJ
holland	NN
worries	NNS
pictures	V
shadows	NNS
employees	NNS
while	IN
possitive	ADJ
dreamy	NNS
stained	V
get	V
accommodation	ADJ
entertaintments	NNS
theres	V
decent	ADJ
reasons	NNS
express	V
twice	ADV
neightborhood	ADV
variuos	ADJ
three	CD
expense	NN
bussiness	NN
steep	ADJ
way	NN
noice	ADJ
moneyi	NN
pleases	NNS
bed	V
but	CC
skype	V
bother	NN
first	ADV
considered	V
bathrooms	NNS
those	DT
orders	NNS
stopped	V
groups	NNS
fountain	V
super	ADJ
sã¶dermalm	NN
awful	ADJ
advise	ADJ
game	NN
plays	V
safe	ADJ
relatively	ADV
make	V
mother	NN
decided	V
aren	NNS
tended	V
underconstruction	ADJ
personal	ADJ
comfortablelounge	NN
foor	NN
swimmingpools	NNS
sunbed	V
pre	ADJ
infrastructure	NN
jean	V
their	PRP$
value	NN
overpriced	V
shelf	NN
didn	NN
reliable	ADJ
general	ADJ
kindly	ADV
countryside	V
an	DT
closer	NN
mohamed	V
where	WRB
suprised	ADJ
insects	NNS
improvement	NN
yaer	NN
par	NN
poland	V
spaciousthe	ADJ
tv	NN
extremely	ADV
montjuic	ADJ
class	NN
reality	NN
1300	CD
flughaven	NN
thoroughly	ADV
help	V
heard	ADV
inexpensive	ADJ
35	CD
case	NN
checkouts	NNS
situated	V
calling	V
oriental	ADJ
hall	NN
park	NN
bliss	ADJ
nightclubs	NN
gobelins	NNS
playing	V
deal	NN
highlights	NNS
cared	V
likely	ADJ
excusive	ADJ
greek	NN
she	PRP
renovation	V
varieous	ADJ
âd	NN
between	IN
dream	NN
center	NN
handled	V
bit	ADV
greatincredible	ADJ
set	V
breaker	NN
tidy	NN
fat	ADJ
apart	ADV
romantic	ADJ
worse	ADJ
including	V
offers	NNS
towels	NNS
enjoyable	ADJ
advantage	NN
invited	V
piece	ADV
luxurious	ADJ
trash	NN
maintained	V
anywhere	ADV
executive	ADJ
titanic	ADJ
offering	NN
d	NN
animation	NN
rubber	NN
prepare	NN
weren	NNS
need	V
sunbeds	NNS
person	NN
more	ADJ
possibly	ADV
negative	ADJ
they	PRP
egg	V
sensational	ADJ
making	NN
blocks	NNS
san	V
constantly	ADV
did	V
helping	V
minibar	NN
smelt	V
hotel	NN
pyramid	NN
english	ADJ
staying	NN
costs	NNS
whole	V
walked	ADJ
dishes	NNS
layout	IN
finding	V
budget	NN
everybody	NN
felt	V
conditions	NNS
ât	V
diidn	ADJ
management	NN
recent	ADJ
on	IN
trees	NNS
houses	NNS
complained	V
276	CD
covered	ADJ
funiture	NN
staircase	NN
surprise	NN
wide	ADJ
touring	V
spending	NN
vips	NNS
champs	V
passport	NN
premises	NNS
relaxed	V
spacy	NN
tube	NN
cleanest	NN
walkways	V
charming	V
seats	NNS
weekly	ADV
warmly	ADV
minus	IN
feeling	V
given	V
addition	NN
about	IN
practically	ADV
disco	ADJ
quite	ADV
lanka	ADJ
everything	NN
two	CD
words	NNS
start	V
residential	ADJ
only	ADV
servings	NNS
came	V
confirmation	NN
star	NN
feature	NN
typical	ADJ
builnding	NN
correspond	NN
axaha	NN
disabled	V
higly	ADV
bath	ADJ
spiderweb	NN
flag	NN
book	NN
airport	NN
sharm	NN
job	NN
it	PRP
excursions	V
calimera	NN
domicile	NN
gaps	NNS
crazy	ADJ
departure	NN
seemed	V
cross	ADJ
working	ADJ
period	NN
allowing	V
holidaymy	ADJ
timing	V
milk	NN
enjoyed	V
most	ADJ
christmas	ADJ
attention	NN
system	NN
morning	NN
der	NN
option	NN
casino	NN
service	NN
weekends	V
channel	ADJ
westminster	NN
happy	ADJ
ago	ADV
short	ADJ
frankfurtter	NN
like	IN
type	NN
buses	NNS
mr	V
favourite	ADJ
amel	NN
gran	NN
hof	NN
sure	ADJ
points	NNS
received	V
features	NNS
24	CD
inclusive	ADJ
anybody	NN
thick	NN
connected	V
point	NN
cigarette	NN
ship	NN
suprise	NN
ther	NN
gardens	NNS
verz	V
perfekt	ADJ
tastes	NNS
taught	V
us	PRP
website	V
everywhere	ADV
coming	V
decoration	NN
secure	NN
hear	V
small	ADJ
basin	NN
therefore	IN
bathing	V
provided	V
importen	ADJ
with	IN
old	ADJ
miss	ADJ
lagune	NN
location	NN
unexpected	V
took	V
well	ADV
portions	NNS
â	V
tip	V
its	PRP$
rock	NN
knowledge	NN
owners	NNS
foyer	V
return	V
smsevery	ADJ
visit	NN
early	ADJ
15	CD
alone	ADV
looking	V
met	V
plan	NN
chaos	NN
liquires	V
nice	ADJ
smokers	NNS
hole	V
key	ADJ
mega	ADJ
admire	NN
restourant	NN
afew	NN
tennisfriends	V
flies	NNS
desert	V
ever	ADV
note	V
travellers	NNS
walking	V
colors	NNS
rear	V
les	NNS
designed	V
observations	NNS
delighed	V
bass	NN
break	NN
cleaning	V
his	PRP$
read	NN
driving	V
unclear	ADJ
better	ADV
famous	ADJ
wc	ADJ
connections	NNS
cocktails	NNS
recomend	V
cusines	NNS
rain	V
alphons	NNS
ideally	ADV
disadvantage	ADJ
requires	V
top	ADJ
allocated	V
arrived	V
chipped	NNS
anna	IN
year	NN
serve	V
sauna	NN
wireless	NN
inside	IN
mexican	ADJ
rum	NN
rest	NN
shop	NN
elysee	V
flat	ADJ
if	IN
cycling	V
chance	NN
concept	NN
enjoy	V
nov	ADV
9	CD
complaint	NN
apartments	NNS
almost	ADV
new	ADJ
climbing	V
carte	NN
recomended	V
living	NN
oliver	RP
wife	NN
luggage	NN
dislike	NN
mountains	NNS
honor	ADJ
month	NN
1	CD
campsite	NN
conditioning	NN
unpleasantness	ADJ
horrible	ADJ
bikes	NNS
international	ADJ
important	ADJ
large	ADJ
went	V
served	ADJ
professional	NN
rose	V
13	CD
roadside	ADJ
2012	CD
expected	V
flavouring	V
yard	ADV
offer	NN
again	ADV
seeing	V
landscaped	V
downstairs	NNS
who	WP
languages	V
highways	NNS
laying	V
refund	NN
load	NN
think	V
neighborhoods	NNS
cancelled	V
institute	ADJ
running	V
york	NN
locate	NN
building	NN
near	IN
also	ADV
inn	V
breathtaken	ADJ
event	NN
cheap	ADJ
tho	NN
roof	NN
entertainment	NN
thomsons	NNS
â·	V
asked	V
tram	ADJ
terrific	NN
bedroom	NN
luxor	NN
across	IN
too	ADV
find	ADJ
happiness	ADJ
europe	NN
rotten	V
worth	IN
tanning	V
30	CD
unlike	IN
fine	ADJ
cook	NN
25	CD
destinations	NNS
duty	NN
turkey	NN
except	IN
petros	NNS
ð¢his	V
friendly	ADV
some	DT
someone	NN
burger	NN
responsibility	NN
stress	NN
possibilties	NNS
mall	V
preciseness	ADJ
18th	CD
continue	V
so	ADV
friendy	ADJ
barcelona	NN
pintxos	NN
french	ADJ
any	DT
vivaldi	ADJ
afterwards	NNS
cultures	NNS
just	ADV
tasteful	ADJ
dolphin	ADJ
intersection	NN
inclysive	NN
created	V
channels	NNS
mostly	ADV
special	ADJ
paradise	NN
argue	NN
elysees	NNS
see	V
melia	ADJ
buffet	NNS
do	V
welcomes	NNS
cooking	V
bigger	ADJ
because	IN
interestingin	NN
gorgeous	ADJ
may	MD
welcoming	V
bathroom	NN
winter	NN
nn	NN
jam	NN
impressed	V
air	NN
therethank	NN
marvelous	ADJ
check	NN
port	NN
smell	V
grounds	NNS
necessary	ADJ
however	ADV
starting	V
explain	ADJ
computers	NNS
pipes	NNS
plaesantly	ADV
disclose	V
dirty	NN
tell	NN
spa	NN
quicker	NN
frienly	ADV
comfy	V
request	NN
dame	NN
made	V
weekday	ADJ
smaller	ADJ
heaven	ADV
healthy	ADJ
things	NNS
gym	ADJ
night	NN
somewhere	ADV
charged	V
dining	V
speaks	NNS
chairs	NNS
appart	ADV
sound	V
bathrobes	NNS
lot	NN
elegance	NN
fist	ADJ
pool	NN
kallithea	NN
transport	NN
assorted	V
buiseness	ADJ
receptionist	NN
marinachania	NN
one	CD
versa	NN
function	NN
are	V
dorm	ADJ
nespresso	ADJ
og	NN
redeeming	V
lake	ADJ
recommendations	NNS
george	V
coach	ADJ
issues	NNS
death	NN
90	CD
safisfied	V
professionell	NN
week	NN
dana	NN
nes	NNS
have	V
trailer	V
nearly	ADV
directions	NNS
bar	V
fact	NN
daily	ADJ
tournaments	NNS
style	NN
compact	V
rather	ADV
condition	NN
prefer	V
saw	ADJ
golf	NN
club	NN
complex	ADJ
furniture	NN
isolation	NN
replinished	V
laughed	ADJ
chef	NN
bread	NN
ã	NNP
paths	NNS
wifi	V
hours	NNS
restricted	V
surroundings	NNS
reservation	NN
cake	NN
2010	CD
accommodating	V
ration	NN
apartment	NN
as	IN
surprisingly	ADV
e	V
comparing	V
welcomewould	ADV
supported	V
wanted	V
no	DT
oasis	NN
swimming	V
charme	NN
diner	NN
adults	NNS
competent	NN
restrooms	NNS
amp	V
liked	V
bridge	NN
extended	V
haven	ADV
treated	V
elderly	ADJ
functional	ADJ
during	IN
light	ADJ
mixed	ADJ
50	CD
machine	NN
bright	ADJ
rank	NN
around	IN
purpose	NN
detail	NN
me	PRP
same	ADJ
pubs	FW
confortable	ADJ
destroyed	V
yet	ADV
speed	V
street	NN
dj	NN
mistakes	NNS
busy	ADJ
field	NN
friends	NNS
lobby	ADV
presented	V
helpfulathe	NN
which	WDT
nord	ADV
deira	V
gift	NN
interest	NN
summary	ADJ
traveling	V
until	IN
leave	ADJ
hosts	NNS
shape	V
adjacent	ADJ
mention	NN
deter	NN
hand	NN
comprehensive	ADJ
jumeriah	NN
invite	NN
decorated	V
cannot	ADJ
cabinets	NNS
escalator	V
weather	NN
empty	NN
over	IN
sneaky	ADJ
awesome	ADJ
intrusive	ADJ
territory	NN
tasted	V
1mile	CD
subway	ADJ
cuase	NN
games	NNS
thought	V
tower	ADJ
handicapped	V
clubs	NNS
finishes	NNS
ibis	V
aquagym	ADJ
fingerprints	NNS
wasnt	WDT
outdated	V
insulation	NN
services	NNS
arc	V
till	ADJ
carlton	NN
20	CD
aforesaid	NN
trimphe	NN
refurnished	V
wg	ADJ
vip	NN
ll	NN
found	V
marseillan	ADV
requested	V
still	ADV
hostess	ADJ
menu	NN
knowledgeable	ADJ
possible	ADJ
free	ADJ
villa	NN
interested	ADJ
attentive	ADJ
fantastic	ADJ
stolen	V
sports	NNS
had	V
prado	IN
our	PRP$
public	ADJ
giant	NN
aqua	V
try	NN
jaccuzzi	NN
paid	V
continental	ADJ
miserable	ADJ
zone	NN
would	MD
below	V
spotlessly	ADV
stations	NNS
taking	V
separated	ADJ
lyon	ADJ
area	NN
leaving	V
husaband	NN
deskstop	ADJ
course	NN
m	NN
finish	ADJ
planning	V
palace	NN
from	IN
streetside	NN
assoiated	V
spacious	ADJ
disadvantages	NNS
haque	V
smallest	ADJ
exercise	NN
immediately	ADV
enthusiastic	ADJ
long	ADV
nightclub	ADV
fabulous	ADJ
;	:
problems	NNS
hotelthe	V
flight	NN
less	ADJ
di	ADJ
bars	NNS
future	ADJ
sray	ADJ
change	NN
letdown	NN
procedures	NNS
forum	V
word	NN
distances	NNS
excellent	ADJ
home	NN
pitches	NNS
sri	V
spend	V
junior	ADJ
century	NN
ms	NN
breakfast	NN
known	V
steigenberger	ADJ
current	ADJ
saff	NN
dvd	NN
luxurous	ADJ
march	NN
varied	V
worst	ADJ
ride	ADV
enough	ADV
certain	ADJ
fish	ADJ
italien	NN
hope	NN
double	ADJ
florence	NN
connection	NN
broken	NNS
missed	V
manner	NN
present	ADJ
compared	V
german	ADJ
back	ADV
orly	ADV
cruise	NN
paris	NN
30th	CD
build	NN
accompanied	V
scrambled	V
instead	ADV
taken	V
full	ADJ
reach	NN
itself	PRP
de	ADV
courteous	V
this	DT
wasn	ADJ
children	NNS
variety	NN
arrivals	NNS
faulty	V
plus	CC
priced	V
takes	V
pull	NN
freezing	V
thursday	ADJ
etc	FW
replenished	V
country	NN
basically	ADV
dedicaced	V
immaculately	ADV
completed	V
2	CD
grand	ADJ
activities	NNS
reccomend	V
allow	IN
snorkelling	V
now	ADV
not	ADV
trips	NNS
deprived	V
smelly	ADV
biggest	ADJ
ia	ADJ
animators	NNS
bathtub	V
anyway	ADV
russians	V
perfectly	ADV
am	V
forthcoming	V
although	IN
blend	ADJ
views	NNS
milano	V
length	ADJ
dark	ADJ
linen	NN
design	NN
bands	V
resort	ADJ
beer	NN
print	NN
recommended	V
inspection	NN
noisy	NN
don	NN
be	V
10	CD
restaurant	ADJ
square	NN
moquette	NN
fit	ADJ
twist	NN
