luxury	عیش و آرام
usually	عام طور پر
designed	ڈیزائن
dj	DJ.
flag	پرچم
superb	شاندار
beds	بستر
takes	لیتا ہے
or	یا
amazing	حیرت انگیز
probably	شاید
surf	سرف
cozy	آرام دہ
number	نمبر
miles	میل
now	ابھی
vice	نائب
â·	·
thank	شکریہ
nord	شمال
dark	اندھیرے
lobby	لابی
cake	کیک
return	واپسی
tiny	ٹنی
pleasant	خوشگوار
toiletries	ٹوالیٹری
no	نہیں
brussels	برسلز
extended	توسیع
accommodating	ایڈجسٹنگ
rimini	ریمینی
elysees	elysees.
transport	نقل و حمل
unfriendly	غیر جانبدار
relax	آرام کرو
unacceptable	ناقابل قبول
bugs	کیڑے
700	700.
april	اپریل
most	سب سے زیادہ
wouln	وولن
toast	ٹوسٹ
â¬	â،
haven	ہننا
small	چھوٹے
i	میں
relations	تعلقات
nicely	اچھی طرح سے
hence	لہذا
one	ایک
overal	ہر جگہ
phone	فون
du	سے
job	کام
restaurant	ریستوراں
available	دستیاب
hip	ہپ
features	خصوصیات
easy	آسان
coffee	کافی
bathroom	باتھ روم
lifestyle	طرز زندگی
like	کی طرح
jumeriah	جمیرہ
excusive	حوصلہ افزائی
tower	ٹاور
tidy	خوش
possibilties	امکانات
catered	کڑا
situation	حالات
restored	بحال
rat	چوہا
place	جگہ
liquires	شراب
checking	چیکنگ
leisure	تفریح
brought	لایا
adult	بالغ
polish	پولش
restourant	ریستوراں
rotten	سڑے
points	پوائنٹس
plus	پلس
give	دے دو
conclusion	نتیجہ
began	شروع ہوا
they	وہ
places	مقامات
machine	آلہ
champ	چیمنہ
smelly	بدبودار
5	5.
jacuzzi	jacuzzi
competent	قابل
likely	امکان
pathã©	PathÃ ©.
cant	کینٹ
worked	کام کیا
last	آخری
constantly	مسلسل
interesting	دلچسپ
upper	اوپری
300	300.
call	کال
guys	لوگ
timing	وقت
problem	مسئلہ
accommodation	رہائش
bus	بس
shadows	سائے
y	Y.
stains	داغ
different	مختلف
girls	لڑکیاں
mainly	بنیادی طور پر
secure	محفوظ
across	بھر میں
could	کر سکتے تھے
students	طالب علم
point	پوائنٹ
schiphol	Schiphol.
negative	منفی
surrounding	ارد گرد
exposed	بے نقاب
clerk	کلرک
means	مطلب
barcelona	بارسلونا
balu	گیند
weeks	ہفتوں
cloth	کپڑے
heart	دل
while	جبکہ
anymore	اب
credit	کریڈٹ
was	تھا
decoration	سجاوٹ
saff	پرت
english	انگریزی
linens	linens.
homeless	بے گھر
legs	ٹانگوں
oriental	اورینٹل
brocken	بروکن
below	ذیل میں
hour	گھنٹہ
adjacent	ملحقہ
where	کہاں
worn	پہنا
avoided	سے بچا
connections	کنکشن
residential	رہائشی
corridor	راہداری
buses	بسیں
unhappy	ناخوش
don	ڈان
gilde	Guild.
base	بنیاد
winter	موسم سرما
bloody	خونی
oberoi	اوبرو
apart	الگ
disabled	معذور
duty	فرض
fee	فیس
feels	محسوس ہوتا ہے
cigarrum	Cigarrum.
keys	چابیاں
happiness	خوشی
seats	نشستیں
mould	ڈھالنا
start	شروع
rambla	راملہ
picky	میں picky
key	چابی
became	بن گیا
martha	مارٹا
chldren	بچے
country	ملک
carlton	کارلٹن
breathtaken	سانس لینے
quickly	جلدی
cover	کور
at	پر
swiming	تیراکی
rain	بارش
moneyi	منی
ago	پہلے
big	بگ
hotels	ہوٹل
reviews	جائزے
totally	مکمل طور پر
pleases	خوشی
addition	اضافی
odd	طاق
giant	دیو قامت
amp	AMP.
shabby	خستہ حال
relatively	نسبتا
lost	کھو دیا
minute	منٹ
tuscany	Tuscany.
wall	دیوار
upgrade	اپ گریڈ
attentive	توجہ
;	؛
mins	منٹ
morning	صبح
in	میں
recently	حال ہی میں
solved	حل
specially	خاص طور پر
anything	کچھ بھی
fridge	فرج
facilties	سہولیات
stress	کشیدگی
corner	کونے
knowledge	علم
de	سے
climbs	climbs.
great	زبردست
campsite	کیمپس
ansd	ansd.
her	اس کی
unless	جب تک
during	کے دوران
explain	وضاحت
marvelous	حیرت انگیز
code	کوڈ
selection	انتخاب
champs	چیمپئن
forced	مجبور
unpleasantness	ناپسندی
club	کلب
highly	انتہائی
affordable	سستی
pretty	خوبصورت
cheese	پنیر
budget	بجٹ
nn	این این
messe	میس
splendid	سپلینڈ
simple	سادہ
cuase	وجہ
facility	سہولت
t	ٹی
childrens	بچوں
receptionist	استقبال
fantastically	تصوراتی، بہترین طور پر
afew	کچھ
garden	باغ
restaurants	ریستوراں
highway	ہائی وے
mini	مینی
very	بہت
returning	واپسی
pools	پول
vacationpickalbatros	تعطیلات
acceptable	قابل قبول
used	استعمال کیا
show	شو
delighed	خوش
aren	ارین
exelent	بے حد
inner	اندرونی
floor	فرش
luxuryfood	Luxuryfood.
try	کوشش کریں
euros	یورو
lunch	دوپہر کا کھانا
said	کہا
gone	چلا گیا
downstairs	نیچے
walked	چلا گیا
talking	بات چیت
piece	ٹکڑا
worth	قابل
coming	آ رہے ہیں
entertaintments	entertraintions.
items	اشیاء
wc	WC.
generally	عام طور پر
views	مناظر
myself	خود
15	15.
insects	کیڑوں
drinks	مشروبات
its	یہ
travellers	مسافروں
market	مارکیٹ
requires	ضرورت ہے
employees	ملازمین
instead	اس کے بجائے
animaters	حرکت پذیری
radio	ریڈیو
late	دیر
sun	سورج
pay	ادائیگی
hours	گھنٹے
hall	ہال
nl	NL.
world	دنیا
der	The.
wifi	وائی فائی
sastisfied	مطمئن
planning	منصوبہ بندی
colors	رنگ
palazzo	پالاززو
same	اسی
rail	ریل
canal	کینال
fingerprints	فنگر پرنٹ
extremely	انتہائی
apartments	اپارٹمنٹ
mobile	موبائل
housekeeping	گھریلو خاتون
decided	فیصلہ کیا
bikes	بائک
wooden	لکڑی
dance	رقص
smiling	مسکراہٹ
greets	مبارک ہو
confirmation	تصدیق
enterainment	تفریح
interested	دلچسپی
creaky	پاگل
gran	زبردست
been	کیا گیا
putting	ڈال
dirt	گندگی
care	دیکھ بھال
wish	خواہش
speak	بولا
poland	پولینڈ
famous	مشہور
con	کے ساتھ
being	ہونے کی وجہ سے
certain	کچھ
please	برائے مہربانی
koln	کولن
frequent	اکثر
zone	زون
pipes	پائپ
gaps	خلا
peoplethe	Peoplethe.
improved	بہتر
water	پانی
tasteful	ذائقہ
reply	جواب
gladly	خوشی سے
elina	ایلینا
per	فی
family	خاندان
way	راستہ
audience	سامعین
freezing	منجمد
leaking	leaking.
ate	کھایا
next	اگلے
commonly	عام طور پر
location	مقام
timely	بروقت
tended	معاہدہ
refund	واپس کرنا
generous	بے لوث
theres	theres.
infrastructure	انفراسٹرکچر
staircase	سیڑھی
prepared	تیار
nightclub	نائٹ کلب
cultures	ثقافت
lift	لفٹ
costlier	Coarglier.
laying	ڈال رہا ہے
destroyed	تباہ
shop	دکان
however	البتہ
trash	ردی کی ٹوکری
together	ساتھ ساتھ
dine	تمہارا
arrivals	آمد
exercise	ورزش
isolation	علیحدگی
miss	مس
his	اس کا
2010	2010.
mountains	پہاڑوں
torn	پھینک دیا
ijust	میں صرف
stunning	شاندار
gym	جم
south	جنوب
certainly	یقینی طور پر
cabinets	کابینہ
death	موت
foor	فور
help	مدد
advise	مشورہ
convenience	سہولت
missed	یاد
than	مقابلے
managed	منظم
unclear	غیر واضح
rum	رم.
lights	لائٹس
versa	اس کے علاوہ
and	اور
near	قریب
stars	ستارے
loved	محبت
moquette	قالین
experience	تجربہ
sky	آسمان
noticeable	قابل ذکر
mail	میل
fresh	تازه
wasnt	نہیں تھا
new	نئی
stop	سٹاپ
advantadge	فائدہ
thomsons	تھامسنسن
want	چاہتے ہیں
apartment	اپارٹمنٹ
huge	بھاری
seen	دیکھا
cracked	پھٹے
dirty	گندی
silent	خاموش
someone	کسی
refrigerator	ریفریجریٹر
equipment	سامان
unlike	برعکس
everyone	سب
couples	جوڑے
various	مختلف
liverpool	لیورپول
sufficient	کافی
old	پرانا
dat	کونسا
did	کیا
conected	منسلک
nevertheless	اس کے باوجود
will	کیا
wine	شراب
local	مقامی
glad	خوشی
dorm	چھاترالی
meat	گوشت
siro	سرو
extremly	انتہا پسندی
you	تم
supburb	Supburb.
everything	سب کچھ
practically	عملی طور پر
moments	لمحات
cross	کراس
dinner	رات کا کھانا
vips	VIPS.
14	14.
surprisingly	حیرت انگیز طور پر
assoiated	ایسوسی ایٹ
well	ٹھیک ہے
amp;	amp؛
sell	فروخت
services	خدمات
letdown	Letwdown.
closes	بند
maid	نوکرانی
mostly	زیادہ تر
able	قابل
responsibility	ذمہ داری
because	کیونکہ
mice	چوہوں
olso	اولو
town	شہر
never	کبھی نہیں
fantastic	تصوراتی، بہترین
holidays	چھٹیوں
sleep	نیند
flamenco	Flamenco.
â	â € ™
shame	شرمندگی
prompt	فوری طور پر
dream	خواب
aside	اس کے علاوہ
making	بنانے
first	پہلا
funny	عجیب
jaccuzzi	jaccuzzi.
does	کیا.
beaituful	خوبصورت
much	بہت
altstadt	Altstadt.
excelent	Excelent.
mohamed	محمد
surge	اضافے
are	ہیں
robe	روبو
yet	ابھی تک
haque	ہاک
kuku	کیل
moved	منتقل
stops	رک جاتا ہے
fitnes	صحت
160	160.
garage	گیراج
weekday	ہفتہ
trees	درخت
landscaped	زمین پر
television	ٹیلی ویژن
helping	مدد
joy	خوشی
looked	دیکھا
order	ترتیب
dubai	دبئی
better	بہتر
center	مرکز
awful	خوفناک
elegant	خوبصورت
then	پھر
redeeming	reveeming.
main	مرکزی
break	وقفے
trams	ٹرم
walk	چلنا
maybe	شاید
electrical	الیکٹریکل
pleasantly	خوشگوار
true	سچ
downside	downside.
noisy	شور
side	طرف
business	بزنس
chairs	کرسیاں
directions	ہدایات
scenic	خوبصورت
worse	بدتر
safisfied	مطمئن
less	کم
somewhere	کہیں
europe	یورپ
case	معاملہ
fact	حقیقت یہ ہے
website	ویب سائٹ
online	آن لائن
horrible	خوفناک
deter	جھٹکا
1mile	1mile.
floaties	فلاتھ
only	صرف
jean	جین
road	روڈ
75	75.
holidys	چھٹیوں
paradise	جنت
wife	بیوی
yaer	ڈبلیو ایچ او
hopping	ہاپ
surprise	تعجب
ll	ایل ایل
washbasin	واش بیسن
2	2.
fi	ہو
prefer	ترجیح دیتے ہیں
some	کچھ
immediate	فوری طور پر
reasons	وجوہات
chears	turnes.
flamingo	فیملینگو
beaches	ساحلوں
expectations	توقعات
hof	ہف
state	حالت
reason	وجہ
lyon	lyon.
accomodation	ایڈجسٹ
duck	بطخ
whisky	شراب
higly	Higly.
spiderweb	مکڑی کا جالا
march	مارچ
few	کچھ
enthusiastic	پرجوش
spent	خرچ
knowledgeable	جان بوجھ کر
checked	جانچ پڑتال
over	زیادہ
alanani	کھیل بٹن
waiters	ویٹر
makes	بناتا ہے
welcomed	خیر مقدم
front	فرنٹ
repeatative	بار بار
something	کچھ
suprise	سپرس
bigger	بڑا
confusing	مبہم
design	ڈیزائن
mgmt	MGMT.
personnel	عملے کی
weekenders	ہفتے کے آخر میں
staff	اسٹاف
educated	تعلیم
recomended	دوبارہ تیار
card	کارڈ
efficient	موثر
self	خود
chef	شیف
atmosphere	ماحول
importen	درآمد
feb	فروری
didn	کیا
renovarted	بحال
2013	2013.
light	روشنی
rest	آرام
review	جائزہ لیں
conditions	شرائط
careful	ہوشیار
plage	بیچ
escalator	ایسکلیٹر
ridiculous	مضحکہ خیز
gare	سٹیشن
situated	واقعہ
pompidou	پمپڈو
chipped	چٹائی
connected	منسلک
linen	لینن
replenished	دوبارہ تیار
anna	انا
cuisine	کھانا
personally	ذاتی طور پر
2011	2011.
structure	ساخت
ever	کبھی
udaivilas	udaivilas.
minuscule	minuscule.
powerful	طاقتور
re	دوبارہ
the	The.
quality	معیار
elevator	لفٹ
pubs	پبوں
russians	روسیوں
camp	کیمپ
rear	ریئر
eg	مثال کے طور پر
everybody	سب
add	شامل
friend	دوست
helpfulathe	مددگار
deira	ڈیرہ
issues	مسائل
george	جارج
food	کھانا
convenient	آسان
triump	فتح
floods	سیلاب
possibility	امکان
buiseness	بزنس
relaxatio	آرام
children	بچے
pictures	تصاویر
nights	راتیں
village	گاؤں
comparing	موازنہ
every	ہر کوئی
perfect	کامل
completely	مکمل طور پر
spaciousthe	Spaciiousthe.
oversee	نگرانی
reserved	محفوظ
avoid	بچیں
egg	انڈہ
variuos	مختلف
restricted	محدود
30th	30th.
felt	محسوس
underneath	نیچے
ibis	ibis.
rate	شرح
luxurous	پرتعیش
wide	وسیع
luxurious	پرتعیش
seaside	سمندر کنارے
sasha	ساشا
cleaness	صفائی
downtown	Downtown.
right	ٹھیک ہے
denmark	ڈنمارک
print	پرنٹ کریں
relaxed	آرام دہ اور پرسکون
finest	بہترین
animations	متحرک تصاویر
forthcoming	آنے والے
visit	دورہ
min	مجھے
lock	لاک
repeat	دہرائیں
milano	ملانو
using	استعمال کرتے ہوئے
layout	ترتیب
any	کوئی
slow	سست
delicacies	نازک
interest	دلچسپی
meals	کھانے
current	موجودہ
okay	ٹھیک ہے
complain	شکایت
package	پیکیج
provided	فراہم کی
exceptional	غیر معمولی
higher	اعلی
close	بند کریں
definetely	یقینی طور پر
ample	کافی
boy	لڑکا
leeds	لیڈز
toilet	بیت الخلاء
full	مکمل
travelled	سفر
hard	سخت
patient	صبر
an	ایک
music	موسیقی
went	چلا گیا
range	رینج
immidiately	فوری طور پر
smoked	تمباکو نوشی
recent	حال ہی میں
channels	چینلز
remind	یاد دلاتے ہیں
favourite	پسندیدہ
she	وہی
cleanest	صاف
couldn	نہیں کر سکتا
trying	کوشش کر رہا تھا
beach	بیچ
surely	یقینا
has	ہے
colorful	رنگا رنگ
elevators	لفٹ
times	اوقات
pull	ھیںچو
pre	پیش
realy	حقیقی
peaceful	پرامن
comfortablelounge	آرام دہ اور پرسکون
trier	TRIER.
di	سے
provides	فراہم کرتا ہے
bands	بینڈ
passport	پاسپورٹ
sunny	سنی
poor	غریب
also	بھی
flower	پھول
spending	خرچ
future	مستقبل
juices	رس
restrooms	آرام دہ اور پرسکون
eur	یورو.
saw	دیکھا
agia	آغا
vacation	تعطیل
more	مزید
bass	باس
akward	عجیب
golf	گالف
deventer	Deventer.
holiday	چھٹیوں
degrees	ڈگری
definitively	واضح طور پر
needed	ضرورت ہے
tub	ٹب
wireless	وائرلیس
brits	brits.
welcome	خوش آمدید
rank	درجہ بندی
portions	حصوں
expected	متوقع
flughaven	ہوائی اڈہ
coktailsstaff	coktailsstaff
expect	توقع
happily	خوشی سے
roof	چھت
especialy	خاص طور پر
charged	الزام عائد کیا
palace	محل
comfortable	آرام دہ اور پرسکون
trafford	ٹریففرد
swimming	تیراکی
contemporary	ہم عصر
held	منعقد
long	طویل
competences	اہلیت
pitches	pitches.
to	کرنے کے لئے
forward	آگے
domicile	Domicile.
belongings	سامان
straight	براہ راست
separated	الگ کیا
european	یورپی
that	وہی
proximity	قربت
screen	سکرین
oterwise	دوسری صورت میں
amstel	amstel.
hosts	میزبان
goes	جاتا ہے
but	لیکن
bother	پریشان
stupid	بیوقوف
c	C.
months	مہینے
active	فعال
discounts	ڈسکاؤنٹ
milk	دودھ
eat	کھاؤ
check	چیک
claustrophobic	Claustrophobic.
thus	اس طرح
varieties	قسمیں
cook	کک
running	چل رہا ہے
smaller	چھوٹا
welcoming	خوش آمدید
international	بین اقوامی
high	ہائی
mamlouk	mamlouk.
fine	ٹھیک
without	بغیر
exceptionally	غیر معمولی
lanka	لنکا
collapses	collapses.
bit	بٹ
40	40.
woerden	Woerden.
telling	کہہ
unexpected	غیر متوقع
steps	اقدامات
expensive	مہنگا
offers	پیشکش
covered	احاطہ کرتا ہے
desired	مطلوب
visitor	وزیٹر
plan	منصوبہ
arena	ایرینا
trousers	پتلون
procedures	طریقہ کار
aerobic	ایروبک
argue	بحث
weekly	ہفتہ وار
gets	ہو جاتا ہے
purpose	مقصد
90	90.
pizza	پزا
meet	ملاقات
nothing	کچھ نہیں
hell	جہنم
waiter	ویٹر
we	ہم
july	جولائی
allow	اجازت
extrasthe	extrasthe.
note	نوٹ
establishments	اداروں
cars	کاریں
reservations	ریزورٹ
standard	معیار
weren	وارڈ
know	جاننا
ones	وہی
shoping	خریداری
had	تھا
treated	علاج
anywhere	کہیں بھی
tallinn	ٹالن
meal	کھانا
numerous	بہت سے
pond	طالاب
access	رسائی
brilliant	شاندار
visible	نظر انداز
basin	بیسن
scam	جعلی
wear	پہننا
having	کیا
games	کھیل
diner	ڈنر
bathrobes	bathrobes.
nes	جیسا کہ
handle	ہینڈل
les	The.
located	واقع
modern	جدید
ideal	مثالی
spend	خرچ
many	بہت
cruise	کریش
little	لٹل
laughed	ہنسی
wilderness	جنگل
dated	تاریخ
outstanding	شاندار
feature	خصوصیت
roadside	سڑک کے کنارے
partner	ساتھی
aqua	ایکوا
unbelievable	ناقابل یقین
genuine	حقیقی
accompanied	ساتھ ساتھ
stained	داغ
possibly	ممکنہ طور پر
reality	حقیقت
frankfurt	فرینکفرٹ
match	میچ
gobelins	گوبھیوں
houses	گھروں
just	بس
air	ایئر
left	بائیں
life	زندگی
chill	چئل
video	ویڈیو
course	کورس
crazy	پاگل
attractive	پر کشش
blend	مرکب
all	سب
decorative	آرائشی
hamburger	ہیمبرگر
lovely	پیارا، دلکش
anybody	کوئی بھی
tuscan	tuscan.
neightborhood	پڑوسی
d	D.
midnight	آدھی رات
chosen	منتخب کیا
delightful	خوشگوار
helpfull	مددگار
whose	جس کی
trimphe	triomphe.
after	کے بعد
crazily	crazily.
usual	معمول
swimmingpool	swimmingpool.
parts	حصوں
picturesque	تصویر
chose	انتخاب
happy	خوش
already	پہلے سے
excursions	حوصلہ افزائی
4	4.
refurnished	بحالی
kind	قسمت
street	سٹریٹ
stone	پتھر
opinion	رائے
facilities	سہولیات
dusting	دھول
before	پہلے
get	حاصل
queue	قطار
smiles	مسکراہٹ
elysee	elysee.
tourists	سیاحوں
travelodges	Travelodges.
including	بشمول
wonderfully	حیرت انگیز طور پر
rebuilding	تعمیر نو
terrible	خوفناک
pleasure	خوشی
weather	موسم
charge	چارج
e	ای
decent	مہذب
13	13.
pants	پتلون
throw	پھینک دو
stuff	سامان
anyone	کوئی بھی
always	ہمیشہ
nespresso	nespresso.
bath	باتھ
copenhagen	کوپن ہیگن
climation	موسم بہار
travelodge	TravelSodge.
octoberfest	Oktoberfest.
businesstrips	کاروباری ٹرپس
10	10.
mistakes	غلطیاں
aquagym	Aquagym
lake	جھیل
year	سال
yoghurt	دہی
steigenberger	Steigenberger.
reasonable	مناسب
ther	تم
varieous	varieous.
foods	فوڈز
possible	ممکن
if	اگر
cleaned	صاف
plays	ادا کرتا ہے
th	ویں
cereal	اناج
got	ملا
thessaloniki	Thessaloniki
public	عوام
wil	چاہنا
space	جگہ
entertainment	تفریح
save	بچت
siena	سینا
average	اوسط
opportunitys	مواقع
considered	سمجھا
end	آخر
riverside	دریاؤں
cause	وجہ
ensures	یقینی بناتا ہے
actually	اصل میں
respective	متعلقہ
terrace	چھت
wonderful	حیرت انگیز
pillows	تکیا
seeing	دیکھ رہا ہے
major	میجر
transfer	منتقلی
rooms	کمرے
several	کئی
verry	وکر
might	شاید
passed	منظور
informed	اطلاع دی
regard	حوالے
let	چلو
month	مہینہ
smell	بو
weekends	اختتام ہفتہ
276	276.
away	دور
wasn	واش
arrival	آمد
exact	بالکل ٹھیک
rer	رش
rocko	راکو
must	ضروری ہے
dame	ڈیم
goggle	Goggle.
warmbarman	وارمرمرم
400	400.
gorgeous	خوبصورت
period	مدت
carparking	گاڑی کی پارکنگ
condition	حالت
idem	ایسا ہی
fully	مکمل طور پر
entire	پوری
azerbaijan	آذربایجان
holidaymy	چھٹیوں
euro	یورو
back	پیچھے
diffrent	فرق
scale	پیمانے پر
verz	Verse.
charme	توجہ
thought	سوچا
kinds	قسم
excellent	بہترین
fountain	فاؤنٹین
centrally	مرکزی
traveling	سفر
excecutive	ایگزیکٹو
hope	امید
comfort	آرام
grill	گرل
thoroughly	اچھی طرح سے
reliable	قابل اعتماد
consider	غور
bed	بستر
helpful	مددگار
serious	سنگین
bedding	بستر
smelt	مسح
bulgaria	بلغاریہ
hole	سوراخ
tp	ٹی پی
friendy	دوستی
tea	چائے
surprised	تعجب
word	لفظ
croissants	Croissants.
soap	صابن
handicapped	معذور
sunbeds	سنبھالا
forum	فورم
middle	درمیان
madrid	میڈرڈ
tee	ٹی
italien	اٹلی
greek	یونانی
except	کے علاوہ
cottage	کاٹیج
recommendation	سفارش
holes	سوراخ
perfume	خوشبو
products	مصنوعات
highlights	جھلکیاں
heaven	جنت
invite	مدعو
style	انداز
charm	توجہ
nearly	تقریبا
olive	زیتون
minibar	منبر
spacious	وسیع
sorted	ترتیب
bonus	اضافی انعام
pub	پب
else	اور
spa	سپا
shops	دکانیں
distances	فاصلے
recommendable	سفارش کی
tastes	ذائقہ
choose	منتخب کریں
centre	مرکز
say	کہہ دو
assist	مدد
unconfortable	غیر آرام دہ
troubles	مصیبت
real	حقیقی
night	رات
trip	سفر
doing	کر رہے ہیں
nationality	قومیت
organized	منظم
unfortunately	بدقسمتی سے
ms	MS
pool	پول
guests	مہمانوں
booked	بک مارک
pass	پاس
smokers	تمباکو نوشی
frills	فرش
ð¢his	ð ¢ ð ¢
hospitable	مہمان
unmatched	بے ترتیب
london	لندن
therefore	لہذا
weekend	ہفتے کے آخر
worries	تشویش
person	شخص
paper	کاغذ
via	ذریعے
within	اندر
allocated	مختص
people	لوگ
definitely	یقینی طور پر
castelo	قلعہ
into	میں
climb	چڑھنے
day	دن
cooks	کھانا پکانا
sablon	سکرین پرنٹنگ
wery	واریری
think	سوچو
blonde	سنہرے بالوں والی
window	ونڈو
sheets	چادریں
inspection	معائنہ
distance	فاصلے
welcomes	خیر مقدم
received	موصول ہوا
nicest	سب سے اچھا
environment	ماحولیات
heating	حرارتی
enter	درج
resorts	ریزورٹس
nice	اچھا
afterwards	بعد میں
egypts	مصر
eran	تھے
booking	بکنگ
relaxing	آرام
non	غیر
comprehensive	وسیع
started	شروع
periferique	پردیش
should	کیا ہونا چاہئے
how	کیسے
tasteswe	ذائقہ
cottages	کاٹیج
25	25.
bedroom	بیڈروم
thursday	جمعرات
foreign	غیر ملکی
make	بنائیں
compared	مقابلے
singles	سنگلز
columbus	کولمبیا
following	درج ذیل
from	سے
meetings	اجلاس
reccomend	Reccomenc
courses	کورسز
missing	لاپتہ
on	پر
vivaldi	Vivaldi.
presented	پیش
appreciate	کی تعریف
our	ہمارا
insulation	موصلیت
system	نظام
invited	مدعو
am	AM.
length	لمبائی
acoustic	صوتی
prefect	prefect.
cold	سردی
1	1.
towels	تولیے
mood	موڈ
station	سٹیشن
bike	موٹر سائیکل
vas	تم
bar	بار
rock	پتھر
gave	دیا
renewed	تجدید
reseption	استقبال
likewise	اسی طرح
clean	صاف
speaks	بولتا ہے
complained	شکایت
blue	بلیو
adults	بالغوں
stopped	روکا
underground	زیر زمین
elegance	خوبصورتی
shows	شوز
conference	کانفرنس
trips	سفر
swim	sw
vineyards	انگور
ready	تیار
amount	رقم
visiting	ملاحظہ
visited	دورہ
smsevery	Smsevery.
player	پلیئر
20	20.
50	50.
character	کردار
tv	ٹی وی
nite	نائٹ
manner	انداز
rather	بلکہ
doesen	کیا
lanxess	LANXESS.
older	پرانے
steak	اسٹیک
flat	فلیٹ
rent	کرایہ
double	دگنا
described	بیان
five	پانچ
is	ہے
terrific	خوفناک
interestingin	میں دلچسپی
them	انہیں
sunbed	سنبھال
words	الفاظ
stays	رہتا ہے
classiest	بہترین ترین
behind	پیچھے
mother	ماں
among	کے درمیان
deserts	ڈریگن
actual	اصل میں
given	دیا گیا
soon	اسی طرح
alternation	متبادل
marseillan	مارسیلن
profession	پیشہ
climbing	چڑھنے
scrambled	scrambled.
fun	مزہ
type	قسم
spirits	اسپرٹ
twice	دو بار
hurghada	HURGHADA
exceeded	تجاوز کر گئی
clubs	کلب
royal	رائل
nightclubs	نائٹ کلب
slendid	slants.
brandy	برینڈی
so	تو
comforts	آرام
borring	بورنگ.
bubba	بابا
experienced	تجربہ کار
leaving	چھوڑ کر
living	زندہ
hte	hte.
architecture	فن تعمیر
wellness	فلاح و بہبود
byron	بائرن
funiture	فرنیچر
maintained	برقرار رکھا
quiet	خاموش
baku	بکو
slippers	موزے
completed	مکمل
cocktails	کاک
minutes	منٹ
reached	پہنچ گیا
beautiful	خوبصورت
asked	پوچھا
directly	براہ راست
halles	ہال
members	اراکین
manicured	مینیکیور
trouble	مصیبت
house	گھر
surroundings	ارد گرد
safety	حفاظت
happened	ہوا
keep	رہو
feeling	احساس
size	سائز
snorkeling	snorkeling.
courteous	شراکت
og	اور
etc	وغیرہ
second	دوسرا
abundant	بہت زیادہ
enough	کافی
animators	حرکت پذیری
smile	مسکراہٹ
calling	کالنگ
mean	مطلب
touristy	سیاحت
function	تقریب
both	دونوں
technology	ٹیکنالوجی
intersection	چوراہا
mess	گندگی
mountain	ماؤنٹین
own	مالک
whole	پوری
6	6.
satisfied	مطمئن
too	بھی
friendliness	دوستی
would	گا
â±	â.
s	ایس
seems	لگتا ہے
travel	سفر
airport	ہوائی اڈہ
improvement	بہتری
enmenons	Enmenons.
russian	روسی
magical	جادوگر
rose	گلاب
smelled	بدبودار
tornese	Tornese.
about	کے بارے میں
cigarette	سگریٹ
do	کیا
dining	کھانے
spakenburg	Spakenburg.
stationthe	اسٹیشن
transition	منتقلی
fish	مچھلی
touring	ٹورنگ
amsterdam	ایمسٹرڈیم
heard	سنا
menu	مینو
buildings	عمارتیں
cope	نمونہ
square	مربع
computers	کمپیوٹرز
impressed	متاثر
perfekt	کامل
â´	ایک
marriott	میرٹوت
time	وقت
city	شہر
simply	بس
german	جرمن
providing	فراہم کرنا
narrow	تنگ
trailer	ٹریلر
yes	جی ہاں
stylish	سجیلا
daytime	دن کے وقت
departure	روانگی
recommended	سفارش کی
disappointment	مایوسی
tele	ٹیلی
continue	جاری رہے
casino	کیسینو
building	عمارت
recomend	ریستوران
tram	ٹرام
chaos	افراتفری
carpet	قالین
a	A.
ground	زمین
class	کلاس
hotelthe	ہوٹل The.
young	نوجوان
land	زمین
entrance	داخلہ
ritz	رٹیز
cancelled	منسوخ
orly	یالی
beware	خبردار رہو
created	پیدا
district	ضلع
royalty	رائلٹی
detail	تفصیل
disappointed	مایوسی
attention	توجہ
provide	فراہم
boat	کشتی
â	â € œ.
flights	پروازیں
playing	کھیل رہا
amel	عمل
realised	احساس ہوا
dedicaced	سرشار. لگن
metro	میٹرو
egypt	مصر
3am	جنرل
evening	شام
neatly	صاف طور پر
summer	موسم گرما
km	کلومیٹر
manager	مینیجر
professionell	پروفیشنل
spoken	بولی
map	نقشہ
special	خصوصی
registration	اندراج
hamam	باتھ
repair	مرمت
bright	روشن
playground	کھیل کے میدان
named	نامزد
namely	یعنی
twist	موڑ
touristic	سیاحتی
efficiently	مؤثر طریقے سے
allows	اجازت دیتا ہے
